/* lexical grammar */
%lex
%%
\s+  /* skip whitespace */
/* Reserved words *//* ITU CLASSES */'Source_PM-FEP_Binding' return	'Source_PM-FEP_Binding'
'Bound_Input_Interface_PM' return	'Bound_Input_Interface_PM'
'Bidirectional_Access_Transport_Entity' return	'Bidirectional_Access_Transport_Entity'
'Uni_Subnetwork_-_A_So_Connected' return	'Uni_Subnetwork_-_A_So_Connected'
'Output_Interface' return	'Output_Interface'
'Source_LPF-FEP' return	'Source_LPF-FEP'
'Source_Matrix' return	'Source_Matrix'
'T_So_Input_-_So_AP_Bound' return	'T_So_Input_-_So_AP_Bound'
'Sk_Matrix_Bi_Component' return	'Sk_Matrix_Bi_Component'
'Bi_Path_CFTE' return	'Bi_Path_CFTE'
'A_Sk_Output_-_Sk_LPF-FP_Bound' return	'A_Sk_Output_-_Sk_LPF-FP_Bound'
'Unidirectional_A-FP' return	'Unidirectional_A-FP'
'Physical_Media_Input' return	'Physical_Media_Input'
'Active_Sk_PM-FEP_-_PM_NC_connected' return	'Active_Sk_PM-FEP_-_PM_NC_connected'
'Connected_Output_Interface' return	'Connected_Output_Interface'
'Source_M-FP_Bi_Component' return	'Source_M-FP_Bi_Component'
'Adaptation_Sink_Process' return	'Adaptation_Sink_Process'
'Forwarding_End_Point' return	'Forwarding_End_Point'
'Termination_Source_-_LPF_Connected' return	'Termination_Source_-_LPF_Connected'
'A_Sk_Output_-_Sk_SN-FP_Bound' return	'A_Sk_Output_-_Sk_SN-FP_Bound'
'Sink_CFTE_Bi_Component' return	'Sink_CFTE_Bi_Component'
'T_So_Output_-_So_A-FEP_Bound' return	'T_So_Output_-_So_A-FEP_Bound'
'Adaptation_Sink' return	'Adaptation_Sink'
'Binding' return	'Binding'
'SN_-_Termination_Sink_Connected' return	'SN_-_Termination_Sink_Connected'
'Bi_PM_LC' return	'Bi_PM_LC'
'Sink_LP-FP' return	'Sink_LP-FP'
'Forwarding_Function_So_M_Connected' return	'Forwarding_Function_So_M_Connected'
'Topological_SN_Representation' return	'Topological_SN_Representation'
'Sink_PM-FEP' return	'Sink_PM-FEP'
'Sink_Site' return	'Sink_Site'
'Egress_SN_So' return	'Egress_SN_So'
'Active_Intermediate_Bidirectional_SN-FP' return	'Active_Intermediate_Bidirectional_SN-FP'
'Source_CFTE' return	'Source_CFTE'
'A_So_Output_-_So_AP_Bound' return	'A_So_Output_-_So_AP_Bound'
'Access_Point' return	'Access_Point'
'SN_Input_-_So_S-FEP_Bound' return	'SN_Input_-_So_S-FEP_Bound'
'Source_MC' return	'Source_MC'
'Bidirectional_AP' return	'Bidirectional_AP'
'Bound_Output_Interface' return	'Bound_Output_Interface'
'Adaptation_Sink_Output' return	'Adaptation_Sink_Output'
'Bound_Transport_Function' return	'Bound_Transport_Function'
'Physical_Media_Output' return	'Physical_Media_Output'
'Bidirectional_PM-FEP' return	'Bidirectional_PM-FEP'
'Active_Sk_SN-FP_-_Int_CFTE_connected' return	'Active_Sk_SN-FP_-_Int_CFTE_connected'
'Active_So_M-FP_-_So_MC_connected' return	'Active_So_M-FP_-_So_MC_connected'
'Forwarding_Function_LC_' return	'Forwarding_Function_LC_'
'Forwarding_Rule_MC_Sk-So' return	'Forwarding_Rule_MC_Sk-So'
'PM_LC' return	'PM_LC'
'LPF_So_Bidirectional_Component' return	'LPF_So_Bidirectional_Component'
'Source_M-FEP_Binding' return	'Source_M-FEP_Binding'
'Sink_SN-FEP' return	'Sink_SN-FEP'
'Unidirectional_PM_NC' return	'Unidirectional_PM_NC'
'Matrix_Connection' return	'Matrix_Connection'
'Sink_SN-FP' return	'Sink_SN-FP'
'Source_SN-FP_Binding' return	'Source_SN-FP_Binding'
'Source_AP_Bi_Component' return	'Source_AP_Bi_Component'
'A_So_-_Uni_Matrix_Connected' return	'A_So_-_Uni_Matrix_Connected'
'Bidirectional_Path_FEP' return	'Bidirectional_Path_FEP'
'Uni_Sk-So_Matrix_Bi_Component' return	'Uni_Sk-So_Matrix_Bi_Component'
'Access_Group' return	'Access_Group'
'Egress_MC_Sk' return	'Egress_MC_Sk'
'LPF_-_Termination_Source_Connected_' return	'LPF_-_Termination_Source_Connected_'
'Geographical_Element_With_Alias' return	'Geographical_Element_With_Alias'
'Adaptation_Sink_-_T_Sk_Connected' return	'Adaptation_Sink_-_T_Sk_Connected'
'Fowarding_Rule_Sk_SN' return	'Fowarding_Rule_Sk_SN'
'LPF_Input_-_Sk_LPF-FP_Bound' return	'LPF_Input_-_Sk_LPF-FP_Bound'
'So_CFTE_Forwarding' return	'So_CFTE_Forwarding'
'Sink_LPF-FEP_Binding' return	'Sink_LPF-FEP_Binding'
'Sink_SN-FEP_Binding' return	'Sink_SN-FEP_Binding'
'PM_-_Termination_Sink_Connected' return	'PM_-_Termination_Sink_Connected'
'SN-FP' return	'SN-FP'
'Intermediate_CFTE' return	'Intermediate_CFTE'
'Active_Sk_M-FP_-_Int_MC_connected' return	'Active_Sk_M-FP_-_Int_MC_connected'
'Sink_LPF-FEP_Bi_Component' return	'Sink_LPF-FEP_Bi_Component'
'Equipment' return	'Equipment'
'Adaptation_Sink_-_A_So_Connected' return	'Adaptation_Sink_-_A_So_Connected'
'Access_Transport_Entity' return	'Access_Transport_Entity'
'LC_Composed_Layer_Network' return	'LC_Composed_Layer_Network'
'Intermediate_CFTE_Bi_Component' return	'Intermediate_CFTE_Bi_Component'
'So_Matrix_Bi_Component' return	'So_Matrix_Bi_Component'
'Forwarding_Function_CFTE_Sk' return	'Forwarding_Function_CFTE_Sk'
'Egress_LC' return	'Egress_LC'
'Layer_Network' return	'Layer_Network'
'Path_Layer_Termination' return	'Path_Layer_Termination'
'Bidirectional_Sink-Source_Matrix' return	'Bidirectional_Sink-Source_Matrix'
'Ingress_SN_Sk' return	'Ingress_SN_Sk'
'Equipment_Site_Component' return	'Equipment_Site_Component'
'Termination_Sink_Input' return	'Termination_Sink_Input'
'Bi_Intermediate_MC' return	'Bi_Intermediate_MC'
'Active_End_Bidirectional_SN-FEP' return	'Active_End_Bidirectional_SN-FEP'
'Path_Bidirectional_Matrix' return	'Path_Bidirectional_Matrix'
'A_Sk_Output_-_Sk_M-FP_Bound' return	'A_Sk_Output_-_Sk_M-FP_Bound'
'Input' return	'Input'
'M_Output_-_Sk_M-FEP_Bound' return	'M_Output_-_Sk_M-FEP_Bound'
'Source_M-FP' return	'Source_M-FP'
'Egress_MC_Sk-So' return	'Egress_MC_Sk-So'
'Ingress_LC' return	'Ingress_LC'
'A_Sk_Output_-_Sk_LP-FP_Bound' return	'A_Sk_Output_-_Sk_LP-FP_Bound'
'Active_Sk_PM-FEP_-_PM_LC_connected' return	'Active_Sk_PM-FEP_-_PM_LC_connected'
'Active_So_M-FEP_-_So_MC_connected' return	'Active_So_M-FEP_-_So_MC_connected'
'Directly_Bound_Reference_Point' return	'Directly_Bound_Reference_Point'
'Adaptation_Sk_Bidirectional_Component' return	'Adaptation_Sk_Bidirectional_Component'
'PM_-_Termination_Source_Connected' return	'PM_-_Termination_Source_Connected'
'A_Sk_-_Uni_Subnetwork_Connected' return	'A_Sk_-_Uni_Subnetwork_Connected'
'Adaptation_Source_Input' return	'Adaptation_Source_Input'
'Transmission_Media_Layer_Network' return	'Transmission_Media_Layer_Network'
'Bound__Output_Interface_Equipment' return	'Bound__Output_Interface_Equipment'
'Layer_Processor_Sink_Output' return	'Layer_Processor_Sink_Output'
'Source_SN-FP_Bi_Component' return	'Source_SN-FP_Bi_Component'
'Connected_Unidirectional_Matrix' return	'Connected_Unidirectional_Matrix'
'Bidirectional_Termination_-_Bi_M_Connected' return	'Bidirectional_Termination_-_Bi_M_Connected'
'Supporting_LC' return	'Supporting_LC'
'Sink_CFTE' return	'Sink_CFTE'
'Source_AP' return	'Source_AP'
'Termination_Sink_Output' return	'Termination_Sink_Output'
'Layer_Processor_Source_Output' return	'Layer_Processor_Source_Output'
'T_Sk_Input_-_Sk_M-FEP_Bound' return	'T_Sk_Input_-_Sk_M-FEP_Bound'
'Topological_Layer' return	'Topological_Layer'
'NC_Supported_by_CFTE' return	'NC_Supported_by_CFTE'
'Sink_LPF-FEP' return	'Sink_LPF-FEP'
'Possible_Bi_LC_Connected_RP' return	'Possible_Bi_LC_Connected_RP'
'Matrix_Input' return	'Matrix_Input'
'Source_SN-FEP_Bi_Component' return	'Source_SN-FEP_Bi_Component'
'Bidirectional_LPF_-_Bi_Termination_Connected' return	'Bidirectional_LPF_-_Bi_Termination_Connected'
'Sink_M-FEP' return	'Sink_M-FEP'
'Sink_SN-FP_Bi_Component' return	'Sink_SN-FP_Bi_Component'
'LPF_Output_-_So_L-FP_Bound' return	'LPF_Output_-_So_L-FP_Bound'
'Bidirectional_M-FEP' return	'Bidirectional_M-FEP'
'Bidirectional_MC' return	'Bidirectional_MC'
'Connected_Relatable_TC' return	'Connected_Relatable_TC'
'Source_M-FEP_Bi_Component' return	'Source_M-FEP_Bi_Component'
'Composed_Topological_Layer' return	'Composed_Topological_Layer'
'Transport_Funtion_Equipment_Component' return	'Transport_Funtion_Equipment_Component'
'Section_Layer_Network' return	'Section_Layer_Network'
'Bidirectional_Adaptation_-_LPF_Bi_Connected' return	'Bidirectional_Adaptation_-_LPF_Bi_Connected'
'Reference_Point' return	'Reference_Point'
'Geographical_Element' return	'Geographical_Element'
'Termination_So_Bidirectional_Component' return	'Termination_So_Bidirectional_Component'
'Bi_Subnetwork_-_A_Bi_Connected' return	'Bi_Subnetwork_-_A_Bi_Connected'
'Bidirectional_Termination_-_Ag_PM_Connected' return	'Bidirectional_Termination_-_Ag_PM_Connected'
'Layer_Processor_Function' return	'Layer_Processor_Function'
'M_-_Termination_Source_Connected' return	'M_-_Termination_Source_Connected'
'Forwarding_Function_CFTE_Sk-So' return	'Forwarding_Function_CFTE_Sk-So'
'A_So_Input_-_A-FP_Bound' return	'A_So_Input_-_A-FP_Bound'
'Bound_Input_Interface' return	'Bound_Input_Interface'
'Termination_Sk_Bidirectional_Component' return	'Termination_Sk_Bidirectional_Component'
'Source_PM-FEP_Bi_Component' return	'Source_PM-FEP_Bi_Component'
'T_Sk_Input_-_Sk_SN-FEP_Bound' return	'T_Sk_Input_-_Sk_SN-FEP_Bound'
'Unidirectional_Access_Transport_Entity_Bidirectional_Component' return	'Unidirectional_Access_Transport_Entity_Bidirectional_Component'
'M_Input_-_Sk_M-FP_Bound' return	'M_Input_-_Sk_M-FP_Bound'
'Forwarding_Rule_MC_So' return	'Forwarding_Rule_MC_So'
'Directly_Connected_Transport_Entity' return	'Directly_Connected_Transport_Entity'
'Sk_MC_Forwarding' return	'Sk_MC_Forwarding'
'Equipment_Composed_Site' return	'Equipment_Composed_Site'
'Bidirectional_Layer_Processor_-_A_Bi_Connected' return	'Bidirectional_Layer_Processor_-_A_Bi_Connected'
'A_So_Input_-_So_SN-FP_Bound' return	'A_So_Input_-_So_SN-FP_Bound'
'Forwarding_Rule_LC' return	'Forwarding_Rule_LC'
'Source_M-FP_Binding' return	'Source_M-FP_Binding'
'Uni_Matrix_-_A_So_Connected' return	'Uni_Matrix_-_A_So_Connected'
'A_-_Layer_Processor_Sink_Connected' return	'A_-_Layer_Processor_Sink_Connected'
'Sink_LPF-FEP_Bound' return	'Sink_LPF-FEP_Bound'
'Forwarding_Function_CFTE_So-Sk' return	'Forwarding_Function_CFTE_So-Sk'
'Section_Layer_Termination' return	'Section_Layer_Termination'
'LPF_-_Termination_Sink_Connected' return	'LPF_-_Termination_Sink_Connected'
'Layer_Processor_Function_Source' return	'Layer_Processor_Function_Source'
'Supporting_Access_Transport_Entity' return	'Supporting_Access_Transport_Entity'
'Input_Interface' return	'Input_Interface'
'Source_Active_RP_-_Path_LC_connected' return	'Source_Active_RP_-_Path_LC_connected'
'Bidirectional_Adaptation_-_Bi_A_Connected' return	'Bidirectional_Adaptation_-_Bi_A_Connected'
'Bound_Input-Output' return	'Bound_Input-Output'
'Component_Subnetwork' return	'Component_Subnetwork'
'T_Sk_Input_-_Sk_A-FEP_Bound' return	'T_Sk_Input_-_Sk_A-FEP_Bound'
'Client_Path_Layer' return	'Client_Path_Layer'
'Path-Path_Client_Layer' return	'Path-Path_Client_Layer'
'Bidirectional_SN-FP' return	'Bidirectional_SN-FP'
'Bidirectional_Layer_Processor_Function' return	'Bidirectional_Layer_Processor_Function'
'Bidirectional_PM_NC' return	'Bidirectional_PM_NC'
'Uni_Subnetwork_-_A_Sk_Connected' return	'Uni_Subnetwork_-_A_Sk_Connected'
'Bidirectional_Adaptation' return	'Bidirectional_Adaptation'
'Source_SN-FEP' return	'Source_SN-FEP'
'T_So_Output_-_So_SN-FEP_Bound' return	'T_So_Output_-_So_SN-FEP_Bound'
'Bi_A_-_Bidirectional_Termination_Connected' return	'Bi_A_-_Bidirectional_Termination_Connected'
'Sink_MC' return	'Sink_MC'
'Path-Path_Layers_AF' return	'Path-Path_Layers_AF'
'Unidirectional_Sink-Source_Matrix' return	'Unidirectional_Sink-Source_Matrix'
'NC_Supported_by_MC' return	'NC_Supported_by_MC'
'A-FP' return	'A-FP'
'End_CFTE_Bi_Component' return	'End_CFTE_Bi_Component'
'A_Sk_Output_-_Sk_A-FEP_Bound' return	'A_Sk_Output_-_Sk_A-FEP_Bound'
'Forwarding_Rule_So_SN' return	'Forwarding_Rule_So_SN'
'Physical_Media_Layer_Termination' return	'Physical_Media_Layer_Termination'
'Active_Bidirectional_Path_FEP_-_Path_NC_Connected' return	'Active_Bidirectional_Path_FEP_-_Path_NC_Connected'
'Mapped_Input_Interface' return	'Mapped_Input_Interface'
'A_So_Input_-_So_LPF-FP_Bound' return	'A_So_Input_-_So_LPF-FP_Bound'
'Unidirectional_MC' return	'Unidirectional_MC'
'Termination_Sink_Process' return	'Termination_Sink_Process'
'Sink_FEP' return	'Sink_FEP'
'Forwarding_Function_Matrix' return	'Forwarding_Function_Matrix'
'Layer_Processor_Source_Process' return	'Layer_Processor_Source_Process'
'Layer_Processor_Source_-_A_Connected' return	'Layer_Processor_Source_-_A_Connected'
'AP_Forwarding' return	'AP_Forwarding'
'Active_Bidirectional_PM-FEP_-_PM_NC_Connected' return	'Active_Bidirectional_PM-FEP_-_PM_NC_Connected'
'Forwarding_Function_Sk-So_Connected' return	'Forwarding_Function_Sk-So_Connected'
'Active_Sink_AP' return	'Active_Sink_AP'
'Bi_Path_MC' return	'Bi_Path_MC'
'Source_L-FP_Binding' return	'Source_L-FP_Binding'
'Unidirectional_Path_NC_Bidirectional_Component' return	'Unidirectional_Path_NC_Bidirectional_Component'
'Ag_PM_-_Bidirectional_Termination_Connected' return	'Ag_PM_-_Bidirectional_Termination_Connected'
'LP_Input_-_Sk_LP-FP_Bound' return	'LP_Input_-_Sk_LP-FP_Bound'
'Active_So_M-FP_-_Int_MC_connected' return	'Active_So_M-FP_-_Int_MC_connected'
'Topological_M_Representation' return	'Topological_M_Representation'
'Source_A-FEP_Bi_Component' return	'Source_A-FEP_Bi_Component'
'M_-_Termination_Sink_Connected' return	'M_-_Termination_Sink_Connected'
'Termination_Source_-_M_Connected' return	'Termination_Source_-_M_Connected'
'Bi_End_CFTE' return	'Bi_End_CFTE'
'Transmission_Media_Layer_Termination' return	'Transmission_Media_Layer_Termination'
'Sk_CFTE_Forwarding' return	'Sk_CFTE_Forwarding'
'Matrix_Output' return	'Matrix_Output'
'A_So_-_Uni_Subnetwork_Connected' return	'A_So_-_Uni_Subnetwork_Connected'
'T_Sk_Input_-_Sk_PM-FEP_Bound' return	'T_Sk_Input_-_Sk_PM-FEP_Bound'
'Sink_M-FP' return	'Sink_M-FP'
'Path_Connected_Reference_Point' return	'Path_Connected_Reference_Point'
'Possible_Egress_LC' return	'Possible_Egress_LC'
'PM_LC_Bi_Component' return	'PM_LC_Bi_Component'
'A-FP_Binding' return	'A-FP_Binding'
'Single_Equipment_Site_Component' return	'Single_Equipment_Site_Component'
'Forwarding_Rule_Sk-So' return	'Forwarding_Rule_Sk-So'
'Active_Sk_M-FEP_-_Sk_MC_connected' return	'Active_Sk_M-FEP_-_Sk_MC_connected'
'Source_CFTE_Bi_Component' return	'Source_CFTE_Bi_Component'
'Source_FEP' return	'Source_FEP'
'Bidirectional_Termination_-_Bi_LPF_Connection' return	'Bidirectional_Termination_-_Bi_LPF_Connection'
'Termination_Source_-_PM_Connected' return	'Termination_Source_-_PM_Connected'
'Termination_Source_Input' return	'Termination_Source_Input'
'Termination_Sink_-_A_Sk_Connected' return	'Termination_Sink_-_A_Sk_Connected'
'Sink_M-FP_Binding' return	'Sink_M-FP_Binding'
'Mapped_TF_Input' return	'Mapped_TF_Input'
'Client_Section_Layer' return	'Client_Section_Layer'
'Network_Connection' return	'Network_Connection'
'Sink_M-FEP_Binding' return	'Sink_M-FEP_Binding'
'Bidirectional_NC' return	'Bidirectional_NC'
'Active_So_Path-FEP_-_Path_NC_connected' return	'Active_So_Path-FEP_-_Path_NC_connected'
'Sink_MC_Bi_Component' return	'Sink_MC_Bi_Component'
'Source_LP-FP' return	'Source_LP-FP'
'Supporting_NC' return	'Supporting_NC'
'Source_LP-FP_Binding' return	'Source_LP-FP_Binding'
'Termination_Source_Process' return	'Termination_Source_Process'
'Source_AP_Binding' return	'Source_AP_Binding'
'Adaptation_Source' return	'Adaptation_Source'
'PM_Input_-_So_PM-FEP_Bound' return	'PM_Input_-_So_PM-FEP_Bound'
'Related_Layer_Network' return	'Related_Layer_Network'
'Adaptation_Source_Process' return	'Adaptation_Source_Process'
'Termination_Sink_-_M_Connected' return	'Termination_Sink_-_M_Connected'
'LP-FP' return	'LP-FP'
'Possible_LC_Connected_RP' return	'Possible_LC_Connected_RP'
'Egress_MC_So' return	'Egress_MC_So'
'Source_MC_Bi_Component' return	'Source_MC_Bi_Component'
'Uni_A-FP_Bi_Component' return	'Uni_A-FP_Bi_Component'
'SN_Intput_-_Sk_SN-FP_Bound' return	'SN_Intput_-_Sk_SN-FP_Bound'
'Transport_Function' return	'Transport_Function'
'SN_Outtput_-_So_SN-FP_Bound' return	'SN_Outtput_-_So_SN-FP_Bound'
'Site' return	'Site'
'Section-Physical_Media_Layers_AF' return	'Section-Physical_Media_Layers_AF'
'Forwarding' return	'Forwarding'
'Int_MC_Forwarding' return	'Int_MC_Forwarding'
'Termination_Source' return	'Termination_Source'
'Forwarding_Function_CFTE_So' return	'Forwarding_Function_CFTE_So'
'Physical_Media_Layer_Network' return	'Physical_Media_Layer_Network'
'Layer_Processor_Sink_Input' return	'Layer_Processor_Sink_Input'
'Intermediate_MC' return	'Intermediate_MC'
'Active_Intermediate_Bidirectional_M-FP' return	'Active_Intermediate_Bidirectional_M-FP'
'Ingress_SN_So' return	'Ingress_SN_So'
'Matrix' return	'Matrix'
'Layer_Processor_Source_Input' return	'Layer_Processor_Source_Input'
'Bidirectional_M-FP' return	'Bidirectional_M-FP'
'Active_Sk_Path-FEP_-_Path_NC_connected' return	'Active_Sk_Path-FEP_-_Path_NC_connected'
'Sink_PM-FEP_Binding' return	'Sink_PM-FEP_Binding'
'Layer_Processor_Process' return	'Layer_Processor_Process'
'Topological_Subnetwork' return	'Topological_Subnetwork'
'Active_Bidirectional_PM-FEP_-_PM_LC_Connected' return	'Active_Bidirectional_PM-FEP_-_PM_LC_Connected'
'A_So_-_Adaptation_Sink_Connected' return	'A_So_-_Adaptation_Sink_Connected'
'Output' return	'Output'
'Adaptation_Sink_Input' return	'Adaptation_Sink_Input'
'Sink_AP_Binding' return	'Sink_AP_Binding'
'Termination_Sink_-_PM_Connected' return	'Termination_Sink_-_PM_Connected'
'Sink_Matrix' return	'Sink_Matrix'
'Bidirectional_LC' return	'Bidirectional_LC'
'Termination_Function' return	'Termination_Function'
'Source_M-FEP' return	'Source_M-FEP'
'Bidirectional_LPF-FEP' return	'Bidirectional_LPF-FEP'
'Possible_Ingress_LC' return	'Possible_Ingress_LC'
'Bidirectional_A-FP' return	'Bidirectional_A-FP'
'So_MC_Forwarding' return	'So_MC_Forwarding'
'Path_Layer_Network' return	'Path_Layer_Network'
'LC_Connected_RP' return	'LC_Connected_RP'
'T_So_Output_-_So_M-FEP_Bound' return	'T_So_Output_-_So_M-FEP_Bound'
'Connected_Reference_Point' return	'Connected_Reference_Point'
'Source_LPF-FEP_Bi_Component' return	'Source_LPF-FEP_Bi_Component'
'Composed_AG' return	'Composed_AG'
'Sink_AP' return	'Sink_AP'
'M_Output_-_So_M-FP_Bound' return	'M_Output_-_So_M-FP_Bound'
'Sink_Active_RP_-_Path_LC_connected' return	'Sink_Active_RP_-_Path_LC_connected'
'Relatable_Topological_Components' return	'Relatable_Topological_Components'
'Termination_Sink_-_LPF_Connected' return	'Termination_Sink_-_LPF_Connected'
'Mapped_Output_Interface' return	'Mapped_Output_Interface'
'Layer_Processor_Function_Sink' return	'Layer_Processor_Function_Sink'
'Sink_Path_FEP' return	'Sink_Path_FEP'
'Bi_Termination_-_Bidirectional_A_Connected' return	'Bi_Termination_-_Bidirectional_A_Connected'
'Unidirectional_Matrix' return	'Unidirectional_Matrix'
'Termination_Source_Output' return	'Termination_Source_Output'
'Architectural_Component' return	'Architectural_Component'
'Forwarding_Rule' return	'Forwarding_Rule'
'Bidirectional_Path_NC' return	'Bidirectional_Path_NC'
'A_So_Input_-_So_A-FEP_Bound' return	'A_So_Input_-_So_A-FEP_Bound'
'Sink_AP_Bi_Component' return	'Sink_AP_Bi_Component'
'Active_So_PM-FEP_-_PM_LC_connected' return	'Active_So_PM-FEP_-_PM_LC_connected'
'Component_Matrix' return	'Component_Matrix'
'Composed_PM_Layer' return	'Composed_PM_Layer'
'Termination_Source_-_SN_Connected' return	'Termination_Source_-_SN_Connected'
'Unidirectional_PM_NC_Bidirectional_Component' return	'Unidirectional_PM_NC_Bidirectional_Component'
'Bidirectional_FEP' return	'Bidirectional_FEP'
'Unidirectional_NC' return	'Unidirectional_NC'
'Sink_A-FEP_Bi_Component' return	'Sink_A-FEP_Bi_Component'
'PM_Output_-_Sk_PM-FEP_Bound' return	'PM_Output_-_Sk_PM-FEP_Bound'
'Forwarding_Function_CFTE' return	'Forwarding_Function_CFTE'
'Termination_Source_-_A_So_Connected' return	'Termination_Source_-_A_So_Connected'
'Active_Bidirectional_AP' return	'Active_Bidirectional_AP'
'PM_Interface_Bound_Input' return	'PM_Interface_Bound_Input'
'Supporting_CFTE' return	'Supporting_CFTE'
'Bi_M_-_Bidirectional_Termination_Connected' return	'Bi_M_-_Bidirectional_Termination_Connected'
'PM_LC_Forwarding' return	'PM_LC_Forwarding'
'Bidirectional_LP-FP' return	'Bidirectional_LP-FP'
'Server_Physical_Media_Layer' return	'Server_Physical_Media_Layer'
'Mapped_TF_Output' return	'Mapped_TF_Output'
'Ingress_SN_Sk-So' return	'Ingress_SN_Sk-So'
'Physical_Media_Component' return	'Physical_Media_Component'
'Ingress_MC_Sk' return	'Ingress_MC_Sk'
'LPF_Output_-_So_LPF-FP_Bound' return	'LPF_Output_-_So_LPF-FP_Bound'
'Sink_A-FEP_Binding' return	'Sink_A-FEP_Binding'
'TE_Connected_Reference_Point' return	'TE_Connected_Reference_Point'
'Active_Path_Bidirectional_SN-FP' return	'Active_Path_Bidirectional_SN-FP'
'Active_Sk_SN-FEP_-_Sk_CFTE_connected' return	'Active_Sk_SN-FEP_-_Sk_CFTE_connected'
'Egress_SN_Sk-So' return	'Egress_SN_Sk-So'
'Unidirectional_Port' return	'Unidirectional_Port'
'Unidirectional_Subnetwork' return	'Unidirectional_Subnetwork'
'Forwarding_Rule_So-Sk' return	'Forwarding_Rule_So-Sk'
'LPF_Input_-_So_L-FEP_Bound' return	'LPF_Input_-_So_L-FEP_Bound'
'T_So_-_Adaptation_Source_Connected' return	'T_So_-_Adaptation_Source_Connected'
'Bidirectional_SN-FEP' return	'Bidirectional_SN-FEP'
'Single_AG' return	'Single_AG'
'NC_Supported_by_LC' return	'NC_Supported_by_LC'
'Active_Path_Bidirectional_M-FP' return	'Active_Path_Bidirectional_M-FP'
'M-FP' return	'M-FP'
'Unidirectional_Path_NC' return	'Unidirectional_Path_NC'
'T_Sk_Input_-_Sk_LPF-FEP_Bound' return	'T_Sk_Input_-_Sk_LPF-FEP_Bound'
'Active_Sk_M-FP_-_Sk_MC_connected' return	'Active_Sk_M-FP_-_Sk_MC_connected'
'Adaptation_So_Bidirectional_Component' return	'Adaptation_So_Bidirectional_Component'
'Source_LP-FP_Bi_Component' return	'Source_LP-FP_Bi_Component'
'A_Sk_Input_-_Sk_AP_Bound' return	'A_Sk_Input_-_Sk_AP_Bound'
'Single_Termination' return	'Single_Termination'
'Bi_A_-_Bi_Matrix_Connected' return	'Bi_A_-_Bi_Matrix_Connected'
'Adaptation_Function' return	'Adaptation_Function'
'Unidirectional_LC' return	'Unidirectional_LC'
'A_-_LPF_Source_Connected' return	'A_-_LPF_Source_Connected'
'Subnetwork' return	'Subnetwork'
'Active_So_SN-FEP_-_So_CFTE_connected' return	'Active_So_SN-FEP_-_So_CFTE_connected'
'Forwarding_Function_LC_Connected' return	'Forwarding_Function_LC_Connected'
'Sink_M-FP_Bi_Component' return	'Sink_M-FP_Bi_Component'
'Path-Section_Layers_AF' return	'Path-Section_Layers_AF'
'Unidirectional_Access_Transport_Entity' return	'Unidirectional_Access_Transport_Entity'
'Bidirectional_Termination_-_Bi_SN_Connected' return	'Bidirectional_Termination_-_Bi_SN_Connected'
'Bidirectional_Termination_-_Bi_A_Connected' return	'Bidirectional_Termination_-_Bi_A_Connected'
'Subnetwork_Input' return	'Subnetwork_Input'
'Connected_Input_Interface' return	'Connected_Input_Interface'
'Egress_SN_Sk' return	'Egress_SN_Sk'
'Bi_Matrix_-_A_Bi_Connected' return	'Bi_Matrix_-_A_Bi_Connected'
'Forwarding_Function' return	'Forwarding_Function'
'Ingress_MC_Sk-So' return	'Ingress_MC_Sk-So'
'T_So_Output_-_So_LPF-FEP_Bound' return	'T_So_Output_-_So_LPF-FEP_Bound'
'Multiple_Equipment_Composed_Site' return	'Multiple_Equipment_Composed_Site'
'Source_Path_FEP' return	'Source_Path_FEP'
'Site_Component_Equipment' return	'Site_Component_Equipment'
'Active_So_SN-FP_-_Int_CFTE_connected' return	'Active_So_SN-FP_-_Int_CFTE_connected'
'Active_Sk_SN-FEP_-_End_CFTE_connected' return	'Active_Sk_SN-FEP_-_End_CFTE_connected'
'Layer_Processor_Sink_-_A_Connected' return	'Layer_Processor_Sink_-_A_Connected'
'Bidirectional_Connected_Subnetwork' return	'Bidirectional_Connected_Subnetwork'
'Active_Sk_SN-FP_-_Sk_CFTE_connected' return	'Active_Sk_SN-FP_-_Sk_CFTE_connected'
'Source_Site' return	'Source_Site'
'PM_NC_Forwarding' return	'PM_NC_Forwarding'
'Server_Path_Layer' return	'Server_Path_Layer'
'Matrix_Composed_Path_Layer' return	'Matrix_Composed_Path_Layer'
'Bi_Intermediate_CFTE' return	'Bi_Intermediate_CFTE'
'Source_A-FEP' return	'Source_A-FEP'
'End_CFTE' return	'End_CFTE'
'Co-located_Termination' return	'Co-located_Termination'
'Sink_LP-FP_Bi_Component' return	'Sink_LP-FP_Bi_Component'
'Bi_SN_-_Bidirectional_Termination_Connected' return	'Bi_SN_-_Bidirectional_Termination_Connected'
'T_So_Output_-_So_PM-FEP_Bound' return	'T_So_Output_-_So_PM-FEP_Bound'
'Int_CFTE_Forwarding' return	'Int_CFTE_Forwarding'
'Active_Possible_Bi_LC_Connected_RP' return	'Active_Possible_Bi_LC_Connected_RP'
'Intermediate_MC_Bi_Component' return	'Intermediate_MC_Bi_Component'
'Adaptation_Source_-_T_So_Connected' return	'Adaptation_Source_-_T_So_Connected'
'Source_LPF-FEP_Binding' return	'Source_LPF-FEP_Binding'
'Ingress_SN_So-Sk' return	'Ingress_SN_So-Sk'
'LPF_Sk_Bidirectional_Component' return	'LPF_Sk_Bidirectional_Component'
'A_Sk_-_Uni_Matrix_Connected' return	'A_Sk_-_Uni_Matrix_Connected'
'Aggregated_Physical_Media' return	'Aggregated_Physical_Media'
'Supporting_MC' return	'Supporting_MC'
'Source_SN-FEP_Binding' return	'Source_SN-FEP_Binding'
'Sink_SN-FEP_Bi_Component' return	'Sink_SN-FEP_Bi_Component'
'Bidirectional_Matrix' return	'Bidirectional_Matrix'
'SN_Output_-_Sk_S-FEP_Bound' return	'SN_Output_-_Sk_S-FEP_Bound'
'T_Sk_-_Adaptation_Sink_Connected' return	'T_Sk_-_Adaptation_Sink_Connected'
'Sink_LP-FP_Binding' return	'Sink_LP-FP_Binding'
'Topological_Component' return	'Topological_Component'
'Adaptation_Source_Output' return	'Adaptation_Source_Output'
'Termination_Sink' return	'Termination_Sink'
'Topological_Link' return	'Topological_Link'
'Termination_Sink_-_SN_Connected' return	'Termination_Sink_-_SN_Connected'
'Physical_Media' return	'Physical_Media'
'Path_LC' return	'Path_LC'
'Bidirectional_CFTE' return	'Bidirectional_CFTE'
'Subnetwork_Output' return	'Subnetwork_Output'
'Active_Source_AP' return	'Active_Source_AP'
'Transport_Entity' return	'Transport_Entity'
'Path-Section_Client_Layer' return	'Path-Section_Client_Layer'
'Forwarding_Rule_MC_Sk' return	'Forwarding_Rule_MC_Sk'
'A_Sk_Output_-_A-FP_Bound' return	'A_Sk_Output_-_A-FP_Bound'
'Bidirectional_Termination' return	'Bidirectional_Termination'
'A_Sk_-_Termination_Sink_Connected' return	'A_Sk_-_Termination_Sink_Connected'
'A_So_Input_-_So_M-FP_Bound' return	'A_So_Input_-_So_M-FP_Bound'
'M_Input_-_So_M-FEP_Bound' return	'M_Input_-_So_M-FEP_Bound'
'Link_Connection' return	'Link_Connection'
'Bidirectional_Adaptation_-_Bi_T_Connected' return	'Bidirectional_Adaptation_-_Bi_T_Connected'
'Sink_SN-FP_Binding' return	'Sink_SN-FP_Binding'
'Uni_Matrix_-_A_Sk_Connected' return	'Uni_Matrix_-_A_Sk_Connected'
'Source_A-FEP_Binding' return	'Source_A-FEP_Binding'
'Subnetwork_Composed_Path_Layer' return	'Subnetwork_Composed_Path_Layer'
'Bound_Input_Interface_Equipment' return	'Bound_Input_Interface_Equipment'
'Transport_Processing_Function' return	'Transport_Processing_Function'
'Bidirectional_A-FEP' return	'Bidirectional_A-FEP'
'Active_So_SN-FP_-_So_CFTE_connected' return	'Active_So_SN-FP_-_So_CFTE_connected'
'Source_PM-FEP' return	'Source_PM-FEP'
'Sink_A-FEP' return	'Sink_A-FEP'
'Single_Equipment_Site' return	'Single_Equipment_Site'
'Forwarding_Function_Sk_M_Connected' return	'Forwarding_Function_Sk_M_Connected'
'Bound_Output_Interface_PM' return	'Bound_Output_Interface_PM'
'Active_So_PM-FEP_-_PM_NC_connected' return	'Active_So_PM-FEP_-_PM_NC_connected'
'End_Forwarding' return	'End_Forwarding'
'SN_-_Termination_Source_Connected' return	'SN_-_Termination_Source_Connected'
'Path_LC_Forwarding' return	'Path_LC_Forwarding'
'Physical_Media_Layer_Component' return	'Physical_Media_Layer_Component'
'Source_SN-FP' return	'Source_SN-FP'
'Ingress_MC_So' return	'Ingress_MC_So'
'PM_Interface_Bound_Output' return	'PM_Interface_Bound_Output'
'Unidirectional_CFTE' return	'Unidirectional_CFTE'
'A_So_-_Termination_Source_Connected' return	'A_So_-_Termination_Source_Connected'
'Sink_PM-FEP_Bi_Component' return	'Sink_PM-FEP_Bi_Component'
'Bi_Path_LC' return	'Bi_Path_LC'
'Sink_M-FEP_Bi_Component' return	'Sink_M-FEP_Bi_Component'
'Active_Path_Bidirectional_M-FEP' return	'Active_Path_Bidirectional_M-FEP'
'A_So_Input_-_So_L-FP_Bound' return	'A_So_Input_-_So_L-FP_Bound'
'Defined_Geographical_Element' return	'Defined_Geographical_Element'
'Single_Physical_Media' return	'Single_Physical_Media'
'Bi_A_-_Bi_Subnetwork_Connected' return	'Bi_A_-_Bi_Subnetwork_Connected'
'Forwarding_Point' return	'Forwarding_Point'
'Component_LPF' return	'Component_LPF'
'Active_So_SN-FEP_-_End_CFTE_connected' return	'Active_So_SN-FEP_-_End_CFTE_connected'
'Active_Path_Bidirectional_SN-FEP' return	'Active_Path_Bidirectional_SN-FEP'
'Channel_Forwarding_Transport_Entity' return	'Channel_Forwarding_Transport_Entity'
'T_Sk_Output_-_Sk_AP_Bound' return	'T_Sk_Output_-_Sk_AP_Bound'
'Path_LC_Bi_Component' return	'Path_LC_Bi_Component'
'LPF_-_Sk_L-FEP_Bound' return	'LPF_-_Sk_L-FEP_Bound'
'Server_Section_Layer' return	'Server_Section_Layer'


/* ITU Relations */
'binds_So_L-FP' return	'binds_So_L-FP'
'INV.set_egress' return	'INV.set_egress'
'componentOf' return	'componentOf'
'supports' return	'supports'
'INV.componentOf' return	'INV.componentOf'
'is_configured_by' return	'is_configured_by'
'INV.represents' return	'INV.represents'
'INV.memberOf' return	'INV.memberOf'
'is_defined_by' return	'is_defined_by'
'set_ingress' return	'set_ingress'
'INV.set_ingress' return	'INV.set_ingress'
'represents' return	'represents'
'INV.is_defined_by' return	'INV.is_defined_by'
'INV.is_configured_by' return	'INV.is_configured_by'
'INV.supports' return	'INV.supports'
'set_egress' return	'set_egress'
'INV.binds_So_L-FP' return	'INV.binds_So_L-FP'
'memberOf' return	'memberOf'
'INV.is_defined_by.Forwarding_Rule_Sk-So.Forwarding_Function_CFTE_Sk-So' return	'INV.is_defined_by.Forwarding_Rule_Sk-So.Forwarding_Function_CFTE_Sk-So'
'is_defined_by.Forwarding_Rule_So-Sk.Forwarding_Function_CFTE_So-Sk' return	'is_defined_by.Forwarding_Rule_So-Sk.Forwarding_Function_CFTE_So-Sk'
'componentOf.Bidirectional_Access_Transport_Entity.Unidirectional_Access_Transport_Entity_Bidirectional_Component' return	'componentOf.Bidirectional_Access_Transport_Entity.Unidirectional_Access_Transport_Entity_Bidirectional_Component'
'componentOf.Bi_Path_LC.Path_LC_Bi_Component' return	'componentOf.Bi_Path_LC.Path_LC_Bi_Component'
'INV.set_ingress.Forwarding_Rule_MC_So.Ingress_MC_So' return	'INV.set_ingress.Forwarding_Rule_MC_So.Ingress_MC_So'
'INV.componentOf.Equipment.Input_Interface' return	'INV.componentOf.Equipment.Input_Interface'
'INV.componentOf.Equipment.Output_Interface' return	'INV.componentOf.Equipment.Output_Interface'
'INV.componentOf.Bidirectional_Access_Transport_Entity.Unidirectional_Access_Transport_Entity_Bidirectional_Component' return	'INV.componentOf.Bidirectional_Access_Transport_Entity.Unidirectional_Access_Transport_Entity_Bidirectional_Component'
'componentOf.Bidirectional_AP.Source_AP_Bi_Component' return	'componentOf.Bidirectional_AP.Source_AP_Bi_Component'
'set_egress.Forwarding_Rule_Sk-So.Egress_SN_Sk-So' return	'set_egress.Forwarding_Rule_Sk-So.Egress_SN_Sk-So'
'INV.componentOf.Topological_Layer.Access_Group' return	'INV.componentOf.Topological_Layer.Access_Group'
'INV.binds_So_L-FP.LP_Input_-_Sk_LP-FP_Bound.A_Sk_Output_-_Sk_LP-FP_Bound' return	'INV.binds_So_L-FP.LP_Input_-_Sk_LP-FP_Bound.A_Sk_Output_-_Sk_LP-FP_Bound'
'set_ingress.Forwarding_Rule_Sk-So.Ingress_SN_Sk-So' return	'set_ingress.Forwarding_Rule_Sk-So.Ingress_SN_Sk-So'
'componentOf.Unidirectional_Subnetwork.Subnetwork_Input' return	'componentOf.Unidirectional_Subnetwork.Subnetwork_Input'
'INV.componentOf.Single_Physical_Media.Physical_Media_Output' return	'INV.componentOf.Single_Physical_Media.Physical_Media_Output'
'componentOf.Adaptation_Sink.Adaptation_Sink_Process' return	'componentOf.Adaptation_Sink.Adaptation_Sink_Process'
'represents.Topological_Layer.Layer_Network' return	'represents.Topological_Layer.Layer_Network'
'is_configured_by.Sk_MC_Forwarding.Forwarding_Function_Sk_M_Connected' return	'is_configured_by.Sk_MC_Forwarding.Forwarding_Function_Sk_M_Connected'
'componentOf.Composed_Topological_Layer.Connected_Relatable_TC' return	'componentOf.Composed_Topological_Layer.Connected_Relatable_TC'
'componentOf.Layer_Processor_Function_Source.Layer_Processor_Source_Output' return	'componentOf.Layer_Processor_Function_Source.Layer_Processor_Source_Output'
'componentOf.Adaptation_Source.Adaptation_Source_Input' return	'componentOf.Adaptation_Source.Adaptation_Source_Input'
'INV.set_egress.Forwarding_Rule_Sk-So.Egress_SN_Sk-So' return	'INV.set_egress.Forwarding_Rule_Sk-So.Egress_SN_Sk-So'
'INV.componentOf.Bi_End_CFTE.End_CFTE_Bi_Component' return	'INV.componentOf.Bi_End_CFTE.End_CFTE_Bi_Component'
'componentOf.Termination_Sink.Termination_Sink_Process' return	'componentOf.Termination_Sink.Termination_Sink_Process'
'componentOf.Bidirectional_LP-FP.Sink_LP-FP_Bi_Component' return	'componentOf.Bidirectional_LP-FP.Sink_LP-FP_Bi_Component'
'set_ingress.Forwarding_Rule_MC_So.Ingress_MC_So' return	'set_ingress.Forwarding_Rule_MC_So.Ingress_MC_So'
'INV.is_configured_by.Int_CFTE_Forwarding.Forwarding_Function_CFTE_Sk-So' return	'INV.is_configured_by.Int_CFTE_Forwarding.Forwarding_Function_CFTE_Sk-So'
'set_ingress.Forwarding_Rule_So_SN.Ingress_SN_So' return	'set_ingress.Forwarding_Rule_So_SN.Ingress_SN_So'
'componentOf.Single_Physical_Media.Physical_Media_Output' return	'componentOf.Single_Physical_Media.Physical_Media_Output'
'componentOf.Bidirectional_LP-FP.Source_LP-FP_Bi_Component' return	'componentOf.Bidirectional_LP-FP.Source_LP-FP_Bi_Component'
'INV.componentOf.LC_Composed_Layer_Network.Link_Connection' return	'INV.componentOf.LC_Composed_Layer_Network.Link_Connection'
'binds_So_L-FP.LP_Input_-_Sk_LP-FP_Bound.A_Sk_Output_-_Sk_LP-FP_Bound' return	'binds_So_L-FP.LP_Input_-_Sk_LP-FP_Bound.A_Sk_Output_-_Sk_LP-FP_Bound'
'represents.Single_Equipment_Site.Single_Equipment_Site_Component' return	'represents.Single_Equipment_Site.Single_Equipment_Site_Component'
'INV.componentOf.Bidirectional_SN-FP.Source_SN-FP_Bi_Component' return	'INV.componentOf.Bidirectional_SN-FP.Source_SN-FP_Bi_Component'
'INV.componentOf.Bidirectional_A-FP.Uni_A-FP_Bi_Component' return	'INV.componentOf.Bidirectional_A-FP.Uni_A-FP_Bi_Component'
'INV.componentOf.Bidirectional_Termination.Termination_So_Bidirectional_Component' return	'INV.componentOf.Bidirectional_Termination.Termination_So_Bidirectional_Component'
'INV.componentOf.Bidirectional_M-FP.Sink_M-FP_Bi_Component' return	'INV.componentOf.Bidirectional_M-FP.Sink_M-FP_Bi_Component'
'INV.is_configured_by.So_CFTE_Forwarding.Forwarding_Function_CFTE_So' return	'INV.is_configured_by.So_CFTE_Forwarding.Forwarding_Function_CFTE_So'
'INV.componentOf.Path_Bidirectional_Matrix.Sk_Matrix_Bi_Component' return	'INV.componentOf.Path_Bidirectional_Matrix.Sk_Matrix_Bi_Component'
'componentOf.Physical_Media_Layer_Network.Physical_Media_Layer_Termination' return	'componentOf.Physical_Media_Layer_Network.Physical_Media_Layer_Termination'
'represents.Topological_Link.Link_Connection' return	'represents.Topological_Link.Link_Connection'
'INV.componentOf.Unidirectional_Subnetwork.Subnetwork_Output' return	'INV.componentOf.Unidirectional_Subnetwork.Subnetwork_Output'
'INV.componentOf.Bidirectional_LPF-FEP.Sink_LPF-FEP_Bi_Component' return	'INV.componentOf.Bidirectional_LPF-FEP.Sink_LPF-FEP_Bi_Component'
'componentOf.Composed_PM_Layer.Physical_Media_Layer_Component' return	'componentOf.Composed_PM_Layer.Physical_Media_Layer_Component'
'supports.Supporting_Access_Transport_Entity.Path_LC' return	'supports.Supporting_Access_Transport_Entity.Path_LC'
'INV.componentOf.Termination_Source.Termination_Source_Input' return	'INV.componentOf.Termination_Source.Termination_Source_Input'
'componentOf.Bi_Path_MC.Sink_MC_Bi_Component' return	'componentOf.Bi_Path_MC.Sink_MC_Bi_Component'
'componentOf.Unidirectional_Subnetwork.Subnetwork_Output' return	'componentOf.Unidirectional_Subnetwork.Subnetwork_Output'
'INV.componentOf.Bidirectional_M-FEP.Source_M-FEP_Bi_Component' return	'INV.componentOf.Bidirectional_M-FEP.Source_M-FEP_Bi_Component'
'INV.is_configured_by.End_Forwarding.Forwarding_Function_CFTE_So-Sk' return	'INV.is_configured_by.End_Forwarding.Forwarding_Function_CFTE_So-Sk'
'componentOf.Adaptation_Source.Adaptation_Source_Process' return	'componentOf.Adaptation_Source.Adaptation_Source_Process'
'componentOf.Adaptation_Sink.Adaptation_Sink_Input' return	'componentOf.Adaptation_Sink.Adaptation_Sink_Input'
'INV.componentOf.Bi_Path_CFTE.Sink_CFTE_Bi_Component' return	'INV.componentOf.Bi_Path_CFTE.Sink_CFTE_Bi_Component'
'INV.represents.Topological_Link.Link_Connection' return	'INV.represents.Topological_Link.Link_Connection'
'componentOf.Bidirectional_SN-FEP.Source_SN-FEP_Bi_Component' return	'componentOf.Bidirectional_SN-FEP.Source_SN-FEP_Bi_Component'
'INV.represents.Single_AG.Single_Termination' return	'INV.represents.Single_AG.Single_Termination'
'componentOf.Bidirectional_Layer_Processor_Function.LPF_So_Bidirectional_Component' return	'componentOf.Bidirectional_Layer_Processor_Function.LPF_So_Bidirectional_Component'
'memberOf.Aggregated_Physical_Media.Physical_Media_Component' return	'memberOf.Aggregated_Physical_Media.Physical_Media_Component'
'INV.componentOf.Bi_Path_MC.Source_MC_Bi_Component' return	'INV.componentOf.Bi_Path_MC.Source_MC_Bi_Component'
'INV.set_egress.Fowarding_Rule_Sk_SN.Egress_SN_Sk' return	'INV.set_egress.Fowarding_Rule_Sk_SN.Egress_SN_Sk'
'INV.is_defined_by.Int_MC_Forwarding.Forwarding_Rule_MC_Sk-So' return	'INV.is_defined_by.Int_MC_Forwarding.Forwarding_Rule_MC_Sk-So'
'INV.componentOf.Bidirectional_Adaptation.Adaptation_Sk_Bidirectional_Component' return	'INV.componentOf.Bidirectional_Adaptation.Adaptation_Sk_Bidirectional_Component'
'componentOf.Subnetwork_Composed_Path_Layer.Component_Subnetwork' return	'componentOf.Subnetwork_Composed_Path_Layer.Component_Subnetwork'
'INV.componentOf.Bidirectional_A-FEP.Sink_A-FEP_Bi_Component' return	'INV.componentOf.Bidirectional_A-FEP.Sink_A-FEP_Bi_Component'
'INV.supports.Supporting_NC.Access_Transport_Entity' return	'INV.supports.Supporting_NC.Access_Transport_Entity'
'INV.memberOf.Aggregated_Physical_Media.Physical_Media_Component' return	'INV.memberOf.Aggregated_Physical_Media.Physical_Media_Component'
'INV.componentOf.Bidirectional_M-FP.Source_M-FP_Bi_Component' return	'INV.componentOf.Bidirectional_M-FP.Source_M-FP_Bi_Component'
'INV.componentOf.Bidirectional_Adaptation.Adaptation_So_Bidirectional_Component' return	'INV.componentOf.Bidirectional_Adaptation.Adaptation_So_Bidirectional_Component'
'componentOf.Bidirectional_M-FEP.Source_M-FEP_Bi_Component' return	'componentOf.Bidirectional_M-FEP.Source_M-FEP_Bi_Component'
'componentOf.Single_Physical_Media.Physical_Media_Input' return	'componentOf.Single_Physical_Media.Physical_Media_Input'
'componentOf.Multiple_Equipment_Composed_Site.Equipment_Site_Component' return	'componentOf.Multiple_Equipment_Composed_Site.Equipment_Site_Component'
'INV.is_defined_by.Forwarding_Rule_MC_Sk.Sk_MC_Forwarding' return	'INV.is_defined_by.Forwarding_Rule_MC_Sk.Sk_MC_Forwarding'
'set_egress.Forwarding_Rule_So_SN.Egress_SN_So' return	'set_egress.Forwarding_Rule_So_SN.Egress_SN_So'
'INV.supports.Supporting_CFTE.NC_Supported_by_CFTE' return	'INV.supports.Supporting_CFTE.NC_Supported_by_CFTE'
'INV.binds_So_L-FP.LPF_Output_-_So_L-FP_Bound.A_So_Input_-_So_L-FP_Bound' return	'INV.binds_So_L-FP.LPF_Output_-_So_L-FP_Bound.A_So_Input_-_So_L-FP_Bound'
'INV.represents.Topological_M_Representation.Matrix' return	'INV.represents.Topological_M_Representation.Matrix'
'componentOf.Bidirectional_LPF-FEP.Source_LPF-FEP_Bi_Component' return	'componentOf.Bidirectional_LPF-FEP.Source_LPF-FEP_Bi_Component'
'INV.componentOf.Bidirectional_A-FEP.Source_A-FEP_Bi_Component' return	'INV.componentOf.Bidirectional_A-FEP.Source_A-FEP_Bi_Component'
'set_ingress.Forwarding_Rule_MC_Sk-So.Ingress_MC_Sk-So' return	'set_ingress.Forwarding_Rule_MC_Sk-So.Ingress_MC_Sk-So'
'componentOf.Bi_End_CFTE.End_CFTE_Bi_Component' return	'componentOf.Bi_End_CFTE.End_CFTE_Bi_Component'
'componentOf.Bidirectional_SN-FP.Sink_SN-FP_Bi_Component' return	'componentOf.Bidirectional_SN-FP.Sink_SN-FP_Bi_Component'
'represents.Single_AG.Single_Termination' return	'represents.Single_AG.Single_Termination'
'supports.Supporting_CFTE.NC_Supported_by_CFTE' return	'supports.Supporting_CFTE.NC_Supported_by_CFTE'
'INV.componentOf.Bidirectional_PM-FEP.Source_PM-FEP_Bi_Component' return	'INV.componentOf.Bidirectional_PM-FEP.Source_PM-FEP_Bi_Component'
'componentOf.Bidirectional_Path_NC.Unidirectional_Path_NC_Bidirectional_Component' return	'componentOf.Bidirectional_Path_NC.Unidirectional_Path_NC_Bidirectional_Component'
'INV.componentOf.Unidirectional_Subnetwork.Subnetwork_Input' return	'INV.componentOf.Unidirectional_Subnetwork.Subnetwork_Input'
'INV.componentOf.Matrix_Composed_Path_Layer.Component_Matrix' return	'INV.componentOf.Matrix_Composed_Path_Layer.Component_Matrix'
'componentOf.Termination_Source.Termination_Source_Process' return	'componentOf.Termination_Source.Termination_Source_Process'
'INV.componentOf.Bidirectional_Layer_Processor_Function.LPF_So_Bidirectional_Component' return	'INV.componentOf.Bidirectional_Layer_Processor_Function.LPF_So_Bidirectional_Component'
'is_configured_by.Int_MC_Forwarding.Forwarding_Function_Sk-So_Connected' return	'is_configured_by.Int_MC_Forwarding.Forwarding_Function_Sk-So_Connected'
'INV.set_egress.Forwarding_Rule_MC_Sk-So.Egress_MC_Sk-So' return	'INV.set_egress.Forwarding_Rule_MC_Sk-So.Egress_MC_Sk-So'
'INV.represents.Topological_SN_Representation.Subnetwork' return	'INV.represents.Topological_SN_Representation.Subnetwork'
'INV.componentOf.Bidirectional_Path_NC.Unidirectional_Path_NC_Bidirectional_Component' return	'INV.componentOf.Bidirectional_Path_NC.Unidirectional_Path_NC_Bidirectional_Component'
'componentOf.Termination_Sink.Termination_Sink_Output' return	'componentOf.Termination_Sink.Termination_Sink_Output'
'INV.is_configured_by.Sk_MC_Forwarding.Forwarding_Function_Sk_M_Connected' return	'INV.is_configured_by.Sk_MC_Forwarding.Forwarding_Function_Sk_M_Connected'
'set_ingress.Fowarding_Rule_Sk_SN.Ingress_SN_Sk' return	'set_ingress.Fowarding_Rule_Sk_SN.Ingress_SN_Sk'
'componentOf.Bidirectional_Adaptation.Adaptation_Sk_Bidirectional_Component' return	'componentOf.Bidirectional_Adaptation.Adaptation_Sk_Bidirectional_Component'
'INV.componentOf.Bidirectional_AP.Sink_AP_Bi_Component' return	'INV.componentOf.Bidirectional_AP.Sink_AP_Bi_Component'
'INV.componentOf.Adaptation_Sink.Adaptation_Sink_Process' return	'INV.componentOf.Adaptation_Sink.Adaptation_Sink_Process'
'INV.componentOf.Bidirectional_SN-FEP.Source_SN-FEP_Bi_Component' return	'INV.componentOf.Bidirectional_SN-FEP.Source_SN-FEP_Bi_Component'
'componentOf.Layer_Processor_Function_Source.Layer_Processor_Source_Input' return	'componentOf.Layer_Processor_Function_Source.Layer_Processor_Source_Input'
'supports.Supporting_NC.Access_Transport_Entity' return	'supports.Supporting_NC.Access_Transport_Entity'
'INV.componentOf.Composed_PM_Layer.Physical_Media_Layer_Component' return	'INV.componentOf.Composed_PM_Layer.Physical_Media_Layer_Component'
'INV.set_egress.Forwarding_Rule_MC_Sk.Egress_MC_Sk' return	'INV.set_egress.Forwarding_Rule_MC_Sk.Egress_MC_Sk'
'INV.supports.Supporting_LC.NC_Supported_by_LC' return	'INV.supports.Supporting_LC.NC_Supported_by_LC'
'INV.componentOf.Bidirectional_PM-FEP.Sink_PM-FEP_Bi_Component' return	'INV.componentOf.Bidirectional_PM-FEP.Sink_PM-FEP_Bi_Component'
'INV.is_configured_by.Int_MC_Forwarding.Forwarding_Function_Sk-So_Connected' return	'INV.is_configured_by.Int_MC_Forwarding.Forwarding_Function_Sk-So_Connected'
'INV.set_ingress.Forwarding_Rule_MC_Sk-So.Ingress_MC_Sk-So' return	'INV.set_ingress.Forwarding_Rule_MC_Sk-So.Ingress_MC_Sk-So'
'componentOf.Bidirectional_A-FEP.Source_A-FEP_Bi_Component' return	'componentOf.Bidirectional_A-FEP.Source_A-FEP_Bi_Component'
'INV.componentOf.Layer_Processor_Function_Sink.Layer_Processor_Sink_Output' return	'INV.componentOf.Layer_Processor_Function_Sink.Layer_Processor_Sink_Output'
'componentOf.Bidirectional_M-FEP.Sink_M-FEP_Bi_Component' return	'componentOf.Bidirectional_M-FEP.Sink_M-FEP_Bi_Component'
'componentOf.Bi_Intermediate_CFTE.Intermediate_CFTE_Bi_Component' return	'componentOf.Bi_Intermediate_CFTE.Intermediate_CFTE_Bi_Component'
'componentOf.Bidirectional_Layer_Processor_Function.LPF_Sk_Bidirectional_Component' return	'componentOf.Bidirectional_Layer_Processor_Function.LPF_Sk_Bidirectional_Component'
'is_configured_by.Int_CFTE_Forwarding.Forwarding_Function_CFTE_Sk-So' return	'is_configured_by.Int_CFTE_Forwarding.Forwarding_Function_CFTE_Sk-So'
'INV.componentOf.Path_Layer_Network.Component_LPF' return	'INV.componentOf.Path_Layer_Network.Component_LPF'
'set_ingress.Forwarding_Rule_LC.Ingress_LC' return	'set_ingress.Forwarding_Rule_LC.Ingress_LC'
'INV.represents.Composed_AG.Co-located_Termination' return	'INV.represents.Composed_AG.Co-located_Termination'
'INV.componentOf.Adaptation_Source.Adaptation_Source_Output' return	'INV.componentOf.Adaptation_Source.Adaptation_Source_Output'
'componentOf.Bidirectional_LPF-FEP.Sink_LPF-FEP_Bi_Component' return	'componentOf.Bidirectional_LPF-FEP.Sink_LPF-FEP_Bi_Component'
'INV.componentOf.Path_Bidirectional_Matrix.So_Matrix_Bi_Component' return	'INV.componentOf.Path_Bidirectional_Matrix.So_Matrix_Bi_Component'
'componentOf.Adaptation_Sink.Adaptation_Sink_Output' return	'componentOf.Adaptation_Sink.Adaptation_Sink_Output'
'INV.componentOf.Bi_Intermediate_CFTE.Intermediate_CFTE_Bi_Component' return	'INV.componentOf.Bi_Intermediate_CFTE.Intermediate_CFTE_Bi_Component'
'INV.componentOf.Termination_Source.Termination_Source_Output' return	'INV.componentOf.Termination_Source.Termination_Source_Output'
'set_egress.Forwarding_Rule_MC_Sk.Egress_MC_Sk' return	'set_egress.Forwarding_Rule_MC_Sk.Egress_MC_Sk'
'is_defined_by.Forwarding_Rule_MC_So.Forwarding_Function_So_M_Connected' return	'is_defined_by.Forwarding_Rule_MC_So.Forwarding_Function_So_M_Connected'
'INV.set_ingress.Forwarding_Rule_Sk-So.Ingress_SN_Sk-So' return	'INV.set_ingress.Forwarding_Rule_Sk-So.Ingress_SN_Sk-So'
'set_egress.Forwarding_Rule_So-Sk.Egress_SN_Sk-So' return	'set_egress.Forwarding_Rule_So-Sk.Egress_SN_Sk-So'
'INV.componentOf.Bi_PM_LC.PM_LC_Bi_Component' return	'INV.componentOf.Bi_PM_LC.PM_LC_Bi_Component'
'INV.componentOf.Bidirectional_M-FEP.Sink_M-FEP_Bi_Component' return	'INV.componentOf.Bidirectional_M-FEP.Sink_M-FEP_Bi_Component'
'is_defined_by.Fowarding_Rule_Sk_SN.Forwarding_Function_CFTE_Sk' return	'is_defined_by.Fowarding_Rule_Sk_SN.Forwarding_Function_CFTE_Sk'
'set_egress.Fowarding_Rule_Sk_SN.Egress_SN_Sk' return	'set_egress.Fowarding_Rule_Sk_SN.Egress_SN_Sk'
'componentOf.Bidirectional_SN-FEP.Sink_SN-FEP_Bi_Component' return	'componentOf.Bidirectional_SN-FEP.Sink_SN-FEP_Bi_Component'
'binds_So_L-FP.LPF_Output_-_So_L-FP_Bound.A_So_Input_-_So_L-FP_Bound' return	'binds_So_L-FP.LPF_Output_-_So_L-FP_Bound.A_So_Input_-_So_L-FP_Bound'
'componentOf.Bi_Intermediate_MC.Intermediate_MC_Bi_Component' return	'componentOf.Bi_Intermediate_MC.Intermediate_MC_Bi_Component'
'is_configured_by.So_MC_Forwarding.Forwarding_Function_So_M_Connected' return	'is_configured_by.So_MC_Forwarding.Forwarding_Function_So_M_Connected'
'componentOf.Bidirectional_AP.Sink_AP_Bi_Component' return	'componentOf.Bidirectional_AP.Sink_AP_Bi_Component'
'set_egress.Forwarding_Rule_MC_So.Egress_MC_So' return	'set_egress.Forwarding_Rule_MC_So.Egress_MC_So'
'set_egress.Forwarding_Rule_MC_Sk-So.Egress_MC_Sk-So' return	'set_egress.Forwarding_Rule_MC_Sk-So.Egress_MC_Sk-So'
'INV.componentOf.Multiple_Equipment_Composed_Site.Equipment_Site_Component' return	'INV.componentOf.Multiple_Equipment_Composed_Site.Equipment_Site_Component'
'componentOf.Adaptation_Source.Adaptation_Source_Output' return	'componentOf.Adaptation_Source.Adaptation_Source_Output'
'INV.componentOf.Layer_Processor_Function_Sink.Layer_Processor_Process' return	'INV.componentOf.Layer_Processor_Function_Sink.Layer_Processor_Process'
'is_defined_by.Forwarding_Rule_So_SN.Forwarding_Function_CFTE_So' return	'is_defined_by.Forwarding_Rule_So_SN.Forwarding_Function_CFTE_So'
'INV.set_egress.Forwarding_Rule_So-Sk.Egress_SN_Sk-So' return	'INV.set_egress.Forwarding_Rule_So-Sk.Egress_SN_Sk-So'
'INV.supports.Supporting_MC.NC_Supported_by_MC' return	'INV.supports.Supporting_MC.NC_Supported_by_MC'
'INV.set_ingress.Forwarding_Rule_MC_Sk.Ingress_MC_Sk' return	'INV.set_ingress.Forwarding_Rule_MC_Sk.Ingress_MC_Sk'
'INV.componentOf.Layer_Processor_Function_Source.Layer_Processor_Source_Input' return	'INV.componentOf.Layer_Processor_Function_Source.Layer_Processor_Source_Input'
'componentOf.Unidirectional_Matrix.Matrix_Input' return	'componentOf.Unidirectional_Matrix.Matrix_Input'
'componentOf.Bi_Path_CFTE.Sink_CFTE_Bi_Component' return	'componentOf.Bi_Path_CFTE.Sink_CFTE_Bi_Component'
'INV.componentOf.Bidirectional_AP.Source_AP_Bi_Component' return	'INV.componentOf.Bidirectional_AP.Source_AP_Bi_Component'
'INV.componentOf.Bidirectional_LPF-FEP.Source_LPF-FEP_Bi_Component' return	'INV.componentOf.Bidirectional_LPF-FEP.Source_LPF-FEP_Bi_Component'
'INV.set_egress.Forwarding_Rule_MC_So.Egress_MC_So' return	'INV.set_egress.Forwarding_Rule_MC_So.Egress_MC_So'
'INV.componentOf.Termination_Source.Termination_Source_Process' return	'INV.componentOf.Termination_Source.Termination_Source_Process'
'supports.Supporting_LC.NC_Supported_by_LC' return	'supports.Supporting_LC.NC_Supported_by_LC'
'componentOf.Path_Bidirectional_Matrix.So_Matrix_Bi_Component' return	'componentOf.Path_Bidirectional_Matrix.So_Matrix_Bi_Component'
'INV.componentOf.Adaptation_Sink.Adaptation_Sink_Input' return	'INV.componentOf.Adaptation_Sink.Adaptation_Sink_Input'
'INV.is_defined_by.Forwarding_Rule_So_SN.Forwarding_Function_CFTE_So' return	'INV.is_defined_by.Forwarding_Rule_So_SN.Forwarding_Function_CFTE_So'
'componentOf.Bidirectional_PM-FEP.Sink_PM-FEP_Bi_Component' return	'componentOf.Bidirectional_PM-FEP.Sink_PM-FEP_Bi_Component'
'componentOf.Path_Bidirectional_Matrix.Sk_Matrix_Bi_Component' return	'componentOf.Path_Bidirectional_Matrix.Sk_Matrix_Bi_Component'
'INV.is_defined_by.Forwarding_Rule_So-Sk.Forwarding_Function_CFTE_So-Sk' return	'INV.is_defined_by.Forwarding_Rule_So-Sk.Forwarding_Function_CFTE_So-Sk'
'INV.supports.Supporting_Access_Transport_Entity.Path_LC' return	'INV.supports.Supporting_Access_Transport_Entity.Path_LC'
'INV.is_configured_by.So_MC_Forwarding.Forwarding_Function_So_M_Connected' return	'INV.is_configured_by.So_MC_Forwarding.Forwarding_Function_So_M_Connected'
'INV.componentOf.Physical_Media_Layer_Network.Physical_Media_Layer_Termination' return	'INV.componentOf.Physical_Media_Layer_Network.Physical_Media_Layer_Termination'
'INV.componentOf.Bi_Path_LC.Path_LC_Bi_Component' return	'INV.componentOf.Bi_Path_LC.Path_LC_Bi_Component'
'is_defined_by.Int_MC_Forwarding.Forwarding_Rule_MC_Sk-So' return	'is_defined_by.Int_MC_Forwarding.Forwarding_Rule_MC_Sk-So'
'INV.componentOf.Section_Layer_Network.Section_Layer_Termination' return	'INV.componentOf.Section_Layer_Network.Section_Layer_Termination'
'INV.componentOf.Path_Layer_Network.Path_Layer_Termination' return	'INV.componentOf.Path_Layer_Network.Path_Layer_Termination'
'componentOf.Topological_Layer.Access_Group' return	'componentOf.Topological_Layer.Access_Group'
'componentOf.Layer_Processor_Function_Source.Layer_Processor_Source_Process' return	'componentOf.Layer_Processor_Function_Source.Layer_Processor_Source_Process'
'componentOf.LC_Composed_Layer_Network.Link_Connection' return	'componentOf.LC_Composed_Layer_Network.Link_Connection'
'INV.set_ingress.Fowarding_Rule_Sk_SN.Ingress_SN_Sk' return	'INV.set_ingress.Fowarding_Rule_Sk_SN.Ingress_SN_Sk'
'INV.represents.Single_Equipment_Site.Single_Equipment_Site_Component' return	'INV.represents.Single_Equipment_Site.Single_Equipment_Site_Component'
'INV.is_defined_by.Fowarding_Rule_Sk_SN.Forwarding_Function_CFTE_Sk' return	'INV.is_defined_by.Fowarding_Rule_Sk_SN.Forwarding_Function_CFTE_Sk'
'componentOf.Termination_Source.Termination_Source_Input' return	'componentOf.Termination_Source.Termination_Source_Input'
'componentOf.Matrix_Composed_Path_Layer.Component_Matrix' return	'componentOf.Matrix_Composed_Path_Layer.Component_Matrix'
'represents.Topological_M_Representation.Matrix' return	'represents.Topological_M_Representation.Matrix'
'INV.componentOf.Bidirectional_SN-FEP.Sink_SN-FEP_Bi_Component' return	'INV.componentOf.Bidirectional_SN-FEP.Sink_SN-FEP_Bi_Component'
'INV.is_configured_by.Path_LC_Forwarding.Forwarding_Function_LC_Connected' return	'INV.is_configured_by.Path_LC_Forwarding.Forwarding_Function_LC_Connected'
'INV.is_defined_by.Forwarding_Rule_MC_So.Forwarding_Function_So_M_Connected' return	'INV.is_defined_by.Forwarding_Rule_MC_So.Forwarding_Function_So_M_Connected'
'INV.componentOf.Layer_Processor_Function_Source.Layer_Processor_Source_Process' return	'INV.componentOf.Layer_Processor_Function_Source.Layer_Processor_Source_Process'
'componentOf.Bidirectional_SN-FP.Source_SN-FP_Bi_Component' return	'componentOf.Bidirectional_SN-FP.Source_SN-FP_Bi_Component'
'is_configured_by.Sk_CFTE_Forwarding.Forwarding_Function_CFTE_Sk' return	'is_configured_by.Sk_CFTE_Forwarding.Forwarding_Function_CFTE_Sk'
'INV.componentOf.Bidirectional_LP-FP.Source_LP-FP_Bi_Component' return	'INV.componentOf.Bidirectional_LP-FP.Source_LP-FP_Bi_Component'
'componentOf.Layer_Processor_Function_Sink.Layer_Processor_Process' return	'componentOf.Layer_Processor_Function_Sink.Layer_Processor_Process'
'componentOf.Equipment.Input_Interface' return	'componentOf.Equipment.Input_Interface'
'INV.componentOf.Bi_Path_CFTE.Source_CFTE_Bi_Component' return	'INV.componentOf.Bi_Path_CFTE.Source_CFTE_Bi_Component'
'INV.componentOf.Termination_Sink.Termination_Sink_Output' return	'INV.componentOf.Termination_Sink.Termination_Sink_Output'
'componentOf.Bidirectional_PM_NC.Unidirectional_PM_NC_Bidirectional_Component' return	'componentOf.Bidirectional_PM_NC.Unidirectional_PM_NC_Bidirectional_Component'
'represents.Topological_SN_Representation.Subnetwork' return	'represents.Topological_SN_Representation.Subnetwork'
'componentOf.Equipment.Transport_Funtion_Equipment_Component' return	'componentOf.Equipment.Transport_Funtion_Equipment_Component'
'INV.componentOf.Composed_Topological_Layer.Connected_Relatable_TC' return	'INV.componentOf.Composed_Topological_Layer.Connected_Relatable_TC'
'is_defined_by.Forwarding_Rule_Sk-So.Forwarding_Function_CFTE_Sk-So' return	'is_defined_by.Forwarding_Rule_Sk-So.Forwarding_Function_CFTE_Sk-So'
'componentOf.Layer_Processor_Function_Sink.Layer_Processor_Sink_Output' return	'componentOf.Layer_Processor_Function_Sink.Layer_Processor_Sink_Output'
'is_configured_by.Path_LC_Forwarding.Forwarding_Function_LC_Connected' return	'is_configured_by.Path_LC_Forwarding.Forwarding_Function_LC_Connected'
'INV.componentOf.Bi_Intermediate_MC.Intermediate_MC_Bi_Component' return	'INV.componentOf.Bi_Intermediate_MC.Intermediate_MC_Bi_Component'
'is_defined_by.Forwarding_Rule_MC_Sk.Sk_MC_Forwarding' return	'is_defined_by.Forwarding_Rule_MC_Sk.Sk_MC_Forwarding'
'componentOf.Termination_Sink.Termination_Sink_Input' return	'componentOf.Termination_Sink.Termination_Sink_Input'
'is_configured_by.So_CFTE_Forwarding.Forwarding_Function_CFTE_So' return	'is_configured_by.So_CFTE_Forwarding.Forwarding_Function_CFTE_So'
'INV.componentOf.Layer_Processor_Function_Sink.Layer_Processor_Sink_Input' return	'INV.componentOf.Layer_Processor_Function_Sink.Layer_Processor_Sink_Input'
'INV.componentOf.Bidirectional_LP-FP.Sink_LP-FP_Bi_Component' return	'INV.componentOf.Bidirectional_LP-FP.Sink_LP-FP_Bi_Component'
'INV.componentOf.Adaptation_Source.Adaptation_Source_Input' return	'INV.componentOf.Adaptation_Source.Adaptation_Source_Input'
'componentOf.Termination_Source.Termination_Source_Output' return	'componentOf.Termination_Source.Termination_Source_Output'
'componentOf.Unidirectional_Matrix.Matrix_Output' return	'componentOf.Unidirectional_Matrix.Matrix_Output'
'componentOf.Bi_PM_LC.PM_LC_Bi_Component' return	'componentOf.Bi_PM_LC.PM_LC_Bi_Component'
'componentOf.Bidirectional_M-FP.Source_M-FP_Bi_Component' return	'componentOf.Bidirectional_M-FP.Source_M-FP_Bi_Component'
'INV.componentOf.Termination_Sink.Termination_Sink_Input' return	'INV.componentOf.Termination_Sink.Termination_Sink_Input'
'componentOf.Section_Layer_Network.Section_Layer_Termination' return	'componentOf.Section_Layer_Network.Section_Layer_Termination'
'componentOf.Path_Layer_Network.Component_LPF' return	'componentOf.Path_Layer_Network.Component_LPF'
'set_ingress.Forwarding_Rule_So-Sk.Ingress_SN_So-Sk' return	'set_ingress.Forwarding_Rule_So-Sk.Ingress_SN_So-Sk'
'componentOf.Bidirectional_A-FP.Uni_A-FP_Bi_Component' return	'componentOf.Bidirectional_A-FP.Uni_A-FP_Bi_Component'
'INV.componentOf.Bidirectional_Sink-Source_Matrix.Uni_Sk-So_Matrix_Bi_Component' return	'INV.componentOf.Bidirectional_Sink-Source_Matrix.Uni_Sk-So_Matrix_Bi_Component'
'INV.componentOf.Bidirectional_SN-FP.Sink_SN-FP_Bi_Component' return	'INV.componentOf.Bidirectional_SN-FP.Sink_SN-FP_Bi_Component'
'componentOf.Bidirectional_PM-FEP.Source_PM-FEP_Bi_Component' return	'componentOf.Bidirectional_PM-FEP.Source_PM-FEP_Bi_Component'
'INV.componentOf.Unidirectional_Matrix.Matrix_Input' return	'INV.componentOf.Unidirectional_Matrix.Matrix_Input'
'componentOf.Equipment.Output_Interface' return	'componentOf.Equipment.Output_Interface'
'is_configured_by.End_Forwarding.Forwarding_Function_CFTE_So-Sk' return	'is_configured_by.End_Forwarding.Forwarding_Function_CFTE_So-Sk'
'INV.componentOf.Bidirectional_PM_NC.Unidirectional_PM_NC_Bidirectional_Component' return	'INV.componentOf.Bidirectional_PM_NC.Unidirectional_PM_NC_Bidirectional_Component'
'INV.componentOf.Adaptation_Sink.Adaptation_Sink_Output' return	'INV.componentOf.Adaptation_Sink.Adaptation_Sink_Output'
'componentOf.Layer_Processor_Function_Sink.Layer_Processor_Sink_Input' return	'componentOf.Layer_Processor_Function_Sink.Layer_Processor_Sink_Input'
'INV.componentOf.Adaptation_Source.Adaptation_Source_Process' return	'INV.componentOf.Adaptation_Source.Adaptation_Source_Process'
'set_egress.Forwarding_Rule_LC.Egress_LC' return	'set_egress.Forwarding_Rule_LC.Egress_LC'
'INV.set_ingress.Forwarding_Rule_So_SN.Ingress_SN_So' return	'INV.set_ingress.Forwarding_Rule_So_SN.Ingress_SN_So'
'INV.componentOf.Bidirectional_Termination.Termination_Sk_Bidirectional_Component' return	'INV.componentOf.Bidirectional_Termination.Termination_Sk_Bidirectional_Component'
'set_ingress.Forwarding_Rule_MC_Sk.Ingress_MC_Sk' return	'set_ingress.Forwarding_Rule_MC_Sk.Ingress_MC_Sk'
'INV.componentOf.Subnetwork_Composed_Path_Layer.Component_Subnetwork' return	'INV.componentOf.Subnetwork_Composed_Path_Layer.Component_Subnetwork'
'componentOf.Bidirectional_Adaptation.Adaptation_So_Bidirectional_Component' return	'componentOf.Bidirectional_Adaptation.Adaptation_So_Bidirectional_Component'
'INV.componentOf.Bidirectional_Layer_Processor_Function.LPF_Sk_Bidirectional_Component' return	'INV.componentOf.Bidirectional_Layer_Processor_Function.LPF_Sk_Bidirectional_Component'
'INV.componentOf.Termination_Sink.Termination_Sink_Process' return	'INV.componentOf.Termination_Sink.Termination_Sink_Process'
'componentOf.Bidirectional_Termination.Termination_So_Bidirectional_Component' return	'componentOf.Bidirectional_Termination.Termination_So_Bidirectional_Component'
'supports.Supporting_MC.NC_Supported_by_MC' return	'supports.Supporting_MC.NC_Supported_by_MC'
'INV.componentOf.Single_Physical_Media.Physical_Media_Input' return	'INV.componentOf.Single_Physical_Media.Physical_Media_Input'
'represents.Composed_AG.Co-located_Termination' return	'represents.Composed_AG.Co-located_Termination'
'INV.set_ingress.Forwarding_Rule_LC.Ingress_LC' return	'INV.set_ingress.Forwarding_Rule_LC.Ingress_LC'
'componentOf.Bidirectional_A-FEP.Sink_A-FEP_Bi_Component' return	'componentOf.Bidirectional_A-FEP.Sink_A-FEP_Bi_Component'
'INV.componentOf.Equipment.Transport_Funtion_Equipment_Component' return	'INV.componentOf.Equipment.Transport_Funtion_Equipment_Component'
'INV.componentOf.Bi_Path_MC.Sink_MC_Bi_Component' return	'INV.componentOf.Bi_Path_MC.Sink_MC_Bi_Component'
'componentOf.Bi_Path_CFTE.Source_CFTE_Bi_Component' return	'componentOf.Bi_Path_CFTE.Source_CFTE_Bi_Component'
'INV.componentOf.Layer_Processor_Function_Source.Layer_Processor_Source_Output' return	'INV.componentOf.Layer_Processor_Function_Source.Layer_Processor_Source_Output'
'componentOf.Bidirectional_Sink-Source_Matrix.Uni_Sk-So_Matrix_Bi_Component' return	'componentOf.Bidirectional_Sink-Source_Matrix.Uni_Sk-So_Matrix_Bi_Component'
'componentOf.Bi_Path_MC.Source_MC_Bi_Component' return	'componentOf.Bi_Path_MC.Source_MC_Bi_Component'
'INV.set_egress.Forwarding_Rule_So_SN.Egress_SN_So' return	'INV.set_egress.Forwarding_Rule_So_SN.Egress_SN_So'
'INV.set_egress.Forwarding_Rule_LC.Egress_LC' return	'INV.set_egress.Forwarding_Rule_LC.Egress_LC'
'INV.componentOf.Unidirectional_Matrix.Matrix_Output' return	'INV.componentOf.Unidirectional_Matrix.Matrix_Output'
'componentOf.Bidirectional_Termination.Termination_Sk_Bidirectional_Component' return	'componentOf.Bidirectional_Termination.Termination_Sk_Bidirectional_Component'
'INV.set_ingress.Forwarding_Rule_So-Sk.Ingress_SN_So-Sk' return	'INV.set_ingress.Forwarding_Rule_So-Sk.Ingress_SN_So-Sk'
'INV.represents.Topological_Layer.Layer_Network' return	'INV.represents.Topological_Layer.Layer_Network'
'componentOf.Bidirectional_M-FP.Sink_M-FP_Bi_Component' return	'componentOf.Bidirectional_M-FP.Sink_M-FP_Bi_Component'
'INV.is_configured_by.Sk_CFTE_Forwarding.Forwarding_Function_CFTE_Sk' return	'INV.is_configured_by.Sk_CFTE_Forwarding.Forwarding_Function_CFTE_Sk'
'componentOf.Path_Layer_Network.Path_Layer_Termination' return	'componentOf.Path_Layer_Network.Path_Layer_Termination'
'INV.binds_So_A-FEP' return	'INV.binds_So_A-FEP'
'INV.has_equipment' return	'INV.has_equipment'
'INV.is_represented_by_So_SN-FP' return	'INV.is_represented_by_So_SN-FP'
'INV.is_represented_by_Sk_M-FEP' return	'INV.is_represented_by_Sk_M-FEP'
'Forwarding_End_CFTE' return	'Forwarding_End_CFTE'
'INV.T-PM_Source_Connection' return	'INV.T-PM_Source_Connection'
'Forwarding_Bidirectional_End_CFTE' return	'Forwarding_Bidirectional_End_CFTE'
'INV.binds_So_A-FEP_to' return	'INV.binds_So_A-FEP_to'
'binds_So_LPF-FEP' return	'binds_So_LPF-FEP'
'is_represented_by_A-FP' return	'is_represented_by_A-FP'
'Forwarding_from_Source_CFTE' return	'Forwarding_from_Source_CFTE'
'Forwarding_from_Sink_MC' return	'Forwarding_from_Sink_MC'
'INV.Forwarding_from_Uni_Access_Transport_Entity' return	'INV.Forwarding_from_Uni_Access_Transport_Entity'
'INV.binds_Sk_A-FEP_from' return	'INV.binds_Sk_A-FEP_from'
'T-PM_Sink_Connection' return	'T-PM_Sink_Connection'
'INV.path' return	'INV.path'
'INV.Forwarding_to_Intermediate_CFTE' return	'INV.Forwarding_to_Intermediate_CFTE'
'Forwarding_from_Sink_CFTE' return	'Forwarding_from_Sink_CFTE'
'binds_Sk_M-FEP_to' return	'binds_Sk_M-FEP_to'
'INV.te_connected' return	'INV.te_connected'
'INV.Forwarding_from_PM_LC' return	'INV.Forwarding_from_PM_LC'
'INV.is_connecting' return	'INV.is_connecting'
'Forwarding_to_PM_LC' return	'Forwarding_to_PM_LC'
'Defined_Geographical_Element.longitude.minute' return	'Defined_Geographical_Element.longitude.minute'
'INV.binds_So_LPF-FP_to' return	'INV.binds_So_LPF-FP_to'
'binds_Sk_SN-FP_from' return	'binds_Sk_SN-FP_from'
'binds_A-FP_to' return	'binds_A-FP_to'
'INV.binds_So_AP' return	'INV.binds_So_AP'
'INV.Forwarding_from_Intermediate_CFTE' return	'INV.Forwarding_from_Intermediate_CFTE'
'Forwarding_from_Intermediate_CFTE' return	'Forwarding_from_Intermediate_CFTE'
'Defined_Geographical_Element.latitude.minute' return	'Defined_Geographical_Element.latitude.minute'
'A-A_Bidirectional_Connection' return	'A-A_Bidirectional_Connection'
'is_represented_by_Intermediate_MC' return	'is_represented_by_Intermediate_MC'
'binds_So_PM-FEP_to' return	'binds_So_PM-FEP_to'
'INV.L-A_Sink_Connection' return	'INV.L-A_Sink_Connection'
'T-M_Source_Connection' return	'T-M_Source_Connection'
'Forwarding_PM_LC' return	'Forwarding_PM_LC'
'binds_Sk_M-FEP' return	'binds_Sk_M-FEP'
'INV.Forwarding_Bidirectional_Path_MC_FP' return	'INV.Forwarding_Bidirectional_Path_MC_FP'
'is_represented_by_Sk_SN-FEP' return	'is_represented_by_Sk_SN-FEP'
'is_represented_by_Sk_M-FEP' return	'is_represented_by_Sk_M-FEP'
'INV.is_represented_by_Source_MC' return	'INV.is_represented_by_Source_MC'
'isDefinedBy' return	'isDefinedBy'
'INV.binding_is_represented_by' return	'INV.binding_is_represented_by'
'Forwarding_Bidirectional_Int_CFTE' return	'Forwarding_Bidirectional_Int_CFTE'
'has_forwarding' return	'has_forwarding'
'binds_Sk_LPF-FEP_to' return	'binds_Sk_LPF-FEP_to'
'INV.Forwarding_to_PM_LC' return	'INV.Forwarding_to_PM_LC'
'binds_Sk_LPF-FP_from' return	'binds_Sk_LPF-FP_from'
'is_represented_by_So_A-FEP' return	'is_represented_by_So_A-FEP'
'INV.Forwarding_from_Intermediate_MC' return	'INV.Forwarding_from_Intermediate_MC'
'INV.LA_-_Bidirectional_Connection' return	'INV.LA_-_Bidirectional_Connection'
'is_represented_by_Sk_AP' return	'is_represented_by_Sk_AP'
'binds_So_LPF-FP_from' return	'binds_So_LPF-FP_from'
'INV.binds_So_SN-FEP' return	'INV.binds_So_SN-FEP'
'INV.A-T_Sink_Connection' return	'INV.A-T_Sink_Connection'
'is_represented_by_Source_CFTE' return	'is_represented_by_Source_CFTE'
'is_represented_by_So_PM-FEP' return	'is_represented_by_So_PM-FEP'
'INV.binds_Sk_AP_from' return	'INV.binds_Sk_AP_from'
'T-L_Source_Connection' return	'T-L_Source_Connection'
'Forwarding_to_Uni_Access_Transport_Entity' return	'Forwarding_to_Uni_Access_Transport_Entity'
'INV.T-A_Sink_Connection' return	'INV.T-A_Sink_Connection'
'INV.Forwarding_from_Sink_CFTE' return	'INV.Forwarding_from_Sink_CFTE'
'L-A_Sink_Connection' return	'L-A_Sink_Connection'
'Forwarding_from_End_CFTE' return	'Forwarding_from_End_CFTE'
'is_represented_by_Uni_PM_NC' return	'is_represented_by_Uni_PM_NC'
'INV.Sn-A_Source_Connection' return	'INV.Sn-A_Source_Connection'
'INV.T-PM_Bidirectional_Connection' return	'INV.T-PM_Bidirectional_Connection'
'interface_binds' return	'interface_binds'
'INV.has_forwarding' return	'INV.has_forwarding'
'INV.Sn-A_Sink_Connection' return	'INV.Sn-A_Sink_Connection'
'INV.binds_So_L-FP_to' return	'INV.binds_So_L-FP_to'
'INV.binds' return	'INV.binds'
'INV.Forwarding_Source_MC' return	'INV.Forwarding_Source_MC'
'binds_Sk_M-FP' return	'binds_Sk_M-FP'
'INV.binds_Sk_L-FP_from' return	'INV.binds_Sk_L-FP_from'
'INV.binds_Sk_LPF-FEP_to' return	'INV.binds_Sk_LPF-FEP_to'
'binds_So_PM-FEP_from' return	'binds_So_PM-FEP_from'
'INV.M-A_Source_Connection' return	'INV.M-A_Source_Connection'
'T-M_Sink_Connection' return	'T-M_Sink_Connection'
'is_represented_by_So_M-FP' return	'is_represented_by_So_M-FP'
'INV.binds_Sk_SN-FEP_from' return	'INV.binds_Sk_SN-FEP_from'
'INV.T-SN_Bidirectional_Connection' return	'INV.T-SN_Bidirectional_Connection'
'te_connected' return	'te_connected'
'INV.T-PM_Sink_Connection' return	'INV.T-PM_Sink_Connection'
'INV.binds_PM_out_interface' return	'INV.binds_PM_out_interface'
'Forwarding_Source_MC' return	'Forwarding_Source_MC'
'is_represented_by_End_CFTE' return	'is_represented_by_End_CFTE'
'binds_So_M-FP_from' return	'binds_So_M-FP_from'
'is_represented_by_So_AP' return	'is_represented_by_So_AP'
'Section-PM_client-server_layer_relationship' return	'Section-PM_client-server_layer_relationship'
'INV.Forwarding_Bidirectional_PM_FEP' return	'INV.Forwarding_Bidirectional_PM_FEP'
'INV.binds_Sk_M-FEP_to' return	'INV.binds_Sk_M-FEP_to'
'INV.binds_Sk_M-FP_from' return	'INV.binds_Sk_M-FP_from'
'is_represented_by_Uni_Access_Transport_Entity' return	'is_represented_by_Uni_Access_Transport_Entity'
'binds_So_LPF-FP_to' return	'binds_So_LPF-FP_to'
'Forwarding_to_End_CFTE' return	'Forwarding_to_End_CFTE'
'INV.maps_input' return	'INV.maps_input'
'binds_So_LPF-FEP_to' return	'binds_So_LPF-FEP_to'
'INV.is_represented_by_Path_LC' return	'INV.is_represented_by_Path_LC'
'INV.binds_Sk_LPF-FEP_from' return	'INV.binds_Sk_LPF-FEP_from'
'INV.Forwarding_Bidirectional_PM_NC' return	'INV.Forwarding_Bidirectional_PM_NC'
'INV.Forwarding_to_Sink_CFTE' return	'INV.Forwarding_to_Sink_CFTE'
'Forwarding_to_Uni_Path_NC' return	'Forwarding_to_Uni_Path_NC'
'binds_Sk_AP_to' return	'binds_Sk_AP_to'
'INV.interface_connects' return	'INV.interface_connects'
'is_represented_by_Sk_A-FEP' return	'is_represented_by_Sk_A-FEP'
'INV.is_represented_by_Sk_AP' return	'INV.is_represented_by_Sk_AP'
'Path-Path_client-server_layer_relationship' return	'Path-Path_client-server_layer_relationship'
'INV.interface_binds' return	'INV.interface_binds'
'INV.binds_So_PM-FEP' return	'INV.binds_So_PM-FEP'
'INV.Forwarding_Bidirectional_Int_CFTE' return	'INV.Forwarding_Bidirectional_Int_CFTE'
'A-T_Sink_Connection' return	'A-T_Sink_Connection'
'maps_input' return	'maps_input'
'INV.Forwarding_to_Uni_Access_Transport_Entity' return	'INV.Forwarding_to_Uni_Access_Transport_Entity'
'binds_Sk_SN-FP_to' return	'binds_Sk_SN-FP_to'
'INV.binds_Sk_LPF-FP' return	'INV.binds_Sk_LPF-FP'
'INV.is_represented_by_Sink_MC' return	'INV.is_represented_by_Sink_MC'
'T-M_Bidirectional_Connection' return	'T-M_Bidirectional_Connection'
'INV.M-A_Bidirectional_Connection' return	'INV.M-A_Bidirectional_Connection'
'is_represented_by_So_SN-FEP' return	'is_represented_by_So_SN-FEP'
'M-A_Source_Connection' return	'M-A_Source_Connection'
'INV.is_represented_by_So_SN-FEP' return	'INV.is_represented_by_So_SN-FEP'
'INV.A-T_Bidirectional_Connection' return	'INV.A-T_Bidirectional_Connection'
'Sn-A_Source_Connection' return	'Sn-A_Source_Connection'
'INV.is_represented_by_So_M-FEP' return	'INV.is_represented_by_So_M-FEP'
'INV.binds_So_SN-FEP_from' return	'INV.binds_So_SN-FEP_from'
'is_represented_by_So_LP-FP' return	'is_represented_by_So_LP-FP'
'INV.T-A_Source_Connection' return	'INV.T-A_Source_Connection'
'is_represented_by_Sk_LP-FP' return	'is_represented_by_Sk_LP-FP'
'INV.binds_Sk_PM-FEP_from' return	'INV.binds_Sk_PM-FEP_from'
'INV.Forwarding_Bidirectional_End_CFTE' return	'INV.Forwarding_Bidirectional_End_CFTE'
'Defined_Geographical_Element.longitude.degree' return	'Defined_Geographical_Element.longitude.degree'
'INV.binds_So_A-FEP_from' return	'INV.binds_So_A-FEP_from'
'INV.binds_So_PM-FEP_to' return	'INV.binds_So_PM-FEP_to'
'INV.M-A_Sink_Connection' return	'INV.M-A_Sink_Connection'
'INV.Forwarding_Path_LC' return	'INV.Forwarding_Path_LC'
'INV.binds_Sk_SN-FEP_to' return	'INV.binds_Sk_SN-FEP_to'
'INV.Forwarding_End_CFTE' return	'INV.Forwarding_End_CFTE'
'INV.Forwarding_from_End_CFTE' return	'INV.Forwarding_from_End_CFTE'
'A-A_Connection' return	'A-A_Connection'
'INV.binds_PM_in_interface' return	'INV.binds_PM_in_interface'
'binds_PM_out_interface' return	'binds_PM_out_interface'
'binds_So_SN-FP_to' return	'binds_So_SN-FP_to'
'INV.binds_So_PM-FEP_from' return	'INV.binds_So_PM-FEP_from'
'INV.Forwarding_to_Sink_MC' return	'INV.Forwarding_to_Sink_MC'
'Forwarding_Source_CFTE' return	'Forwarding_Source_CFTE'
'INV.binds_A-FP' return	'INV.binds_A-FP'
'INV.is_represented_by_Source_CFTE' return	'INV.is_represented_by_Source_CFTE'
'Forwarding_to_Intermediate_CFTE' return	'Forwarding_to_Intermediate_CFTE'
'binds_So_A-FEP_from' return	'binds_So_A-FEP_from'
'Forwarding_Int_CFTE' return	'Forwarding_Int_CFTE'
'INV.binds_Sk_A-FEP_to' return	'INV.binds_Sk_A-FEP_to'
'is_represented_by_So_LPF-FEP' return	'is_represented_by_So_LPF-FEP'
'Geographical_Element_With_Alias.location' return	'Geographical_Element_With_Alias.location'
'INV.is_represented_by_Uni_Path_NC' return	'INV.is_represented_by_Uni_Path_NC'
'Defined_Geographical_Element.longitude.second' return	'Defined_Geographical_Element.longitude.second'
'INV.binds_Sk_M-FEP_from' return	'INV.binds_Sk_M-FEP_from'
'binds_So_M-FEP' return	'binds_So_M-FEP'
'INV.binds_Sk_AP' return	'INV.binds_Sk_AP'
'INV.binds_So_LPF-FEP_to' return	'INV.binds_So_LPF-FEP_to'
'INV.T-M_Bidirectional_Connection' return	'INV.T-M_Bidirectional_Connection'
'binds_So_SN-FEP_from' return	'binds_So_SN-FEP_from'
'binds_Sk_PM-FEP_to' return	'binds_Sk_PM-FEP_to'
'INV.maps_output' return	'INV.maps_output'
'binds_Sk_A-FEP_to' return	'binds_Sk_A-FEP_to'
'INV.T-L_Bidirectional_Connection' return	'INV.T-L_Bidirectional_Connection'
'Forwarding_Bidirectional_Path_MC_FEP' return	'Forwarding_Bidirectional_Path_MC_FEP'
'INV.binds_So_LPF-FP_from' return	'INV.binds_So_LPF-FP_from'
'INV.is_represented_by_So_LPF-FEP' return	'INV.is_represented_by_So_LPF-FEP'
'INV.binds_Sk_LPF-FP_to' return	'INV.binds_Sk_LPF-FP_to'
'binds_Sk_LPF-FEP' return	'binds_Sk_LPF-FEP'
'INV.site_connects' return	'INV.site_connects'
'INV.binds_So_L-FP_from' return	'INV.binds_So_L-FP_from'
'maps_output' return	'maps_output'
'Forwarding_Sink_CFTE' return	'Forwarding_Sink_CFTE'
'INV.is_binding' return	'INV.is_binding'
'INV.binds_So_SN-FP_from' return	'INV.binds_So_SN-FP_from'
'INV.binds_Sk_AP_to' return	'INV.binds_Sk_AP_to'
'INV.binds_Sk_SN-FEP' return	'INV.binds_Sk_SN-FEP'
'INV.is_represented_by_Sk_LP-FP' return	'INV.is_represented_by_Sk_LP-FP'
'binds_Sk_SN-FEP' return	'binds_Sk_SN-FEP'
'is_represented_by_Sk_M-FP' return	'is_represented_by_Sk_M-FP'
'binds_Sk_L-FP_from' return	'binds_Sk_L-FP_from'
'Forwarding_Bidirectional_PM_NC' return	'Forwarding_Bidirectional_PM_NC'
'INV.binds_Sk_SN-FP' return	'INV.binds_Sk_SN-FP'
'binds_Sk_M-FP_from' return	'binds_Sk_M-FP_from'
'binds_Sk_AP_from' return	'binds_Sk_AP_from'
'INV.binds_Sk_M-FEP' return	'INV.binds_Sk_M-FEP'
'INV.Forwarding_Bidirectional_Int_MC' return	'INV.Forwarding_Bidirectional_Int_MC'
'INV.Forwarding_Int_CFTE' return	'INV.Forwarding_Int_CFTE'
'INV.tf_connection' return	'INV.tf_connection'
'INV.Forwarding_from_Source_CFTE' return	'INV.Forwarding_from_Source_CFTE'
'binds_So_A-FEP_to' return	'binds_So_A-FEP_to'
'INV.is_represented_by_End_CFTE' return	'INV.is_represented_by_End_CFTE'
'T-SN_Bidirectional_Connection' return	'T-SN_Bidirectional_Connection'
'Forwarding_to_Sink_MC' return	'Forwarding_to_Sink_MC'
'binds_Sk_A-FEP_from' return	'binds_Sk_A-FEP_from'
'binds_So_A-FEP' return	'binds_So_A-FEP'
'INV.Forwarding_Bidirectional_Path_CFTE_FP' return	'INV.Forwarding_Bidirectional_Path_CFTE_FP'
'T-A_Bidirectional_Connection' return	'T-A_Bidirectional_Connection'
'Forwarding_to_Path_LC' return	'Forwarding_to_Path_LC'
'INV.is_represented_by_So_M-FP' return	'INV.is_represented_by_So_M-FP'
'INV.is_represented_by_Sink_CFTE' return	'INV.is_represented_by_Sink_CFTE'
'binds_Sk_M-FEP_from' return	'binds_Sk_M-FEP_from'
'binds_So_M-FEP_to' return	'binds_So_M-FEP_to'
'INV.Forwarding_to_Path_LC' return	'INV.Forwarding_to_Path_LC'
'T-PM_Bidirectional_Connection' return	'T-PM_Bidirectional_Connection'
'Defined_Geographical_Element.latitude.degree' return	'Defined_Geographical_Element.latitude.degree'
'binds_Sk_LPF-FP' return	'binds_Sk_LPF-FP'
'INV.T-L_Source_Connection' return	'INV.T-L_Source_Connection'
'INV.binds_Sk_LPF-FP_from' return	'INV.binds_Sk_LPF-FP_from'
'INV.A-A_Connection' return	'INV.A-A_Connection'
'binds_So_LPF-FEP_from' return	'binds_So_LPF-FEP_from'
'INV.isDefinedBy' return	'INV.isDefinedBy'
'binds_Sk_SN-FEP_from' return	'binds_Sk_SN-FEP_from'
'Forwarding_to_Source_MC' return	'Forwarding_to_Source_MC'
'is_represented_by_So_L-FP' return	'is_represented_by_So_L-FP'
'binds_Sk_L-FP_to' return	'binds_Sk_L-FP_to'
'is_represented_by_Path_LC' return	'is_represented_by_Path_LC'
'INV.Forwarding_from_Path_LC' return	'INV.Forwarding_from_Path_LC'
'INV.binds_So_LPF-FEP_from' return	'INV.binds_So_LPF-FEP_from'
'INV.binds_So_SN-FP_to' return	'INV.binds_So_SN-FP_to'
'INV.connects' return	'INV.connects'
'binds_So_AP_to' return	'binds_So_AP_to'
'INV.Forwarding_from_Uni_Path_NC' return	'INV.Forwarding_from_Uni_Path_NC'
'INV.is_represented_by_Sk_M-FP' return	'INV.is_represented_by_Sk_M-FP'
'M-A_Sink_Connection' return	'M-A_Sink_Connection'
'Defined_Geographical_Element.latitude.second' return	'Defined_Geographical_Element.latitude.second'
'INV.binds_So_SN-FEP_to' return	'INV.binds_So_SN-FEP_to'
'client-server_layer_relationship' return	'client-server_layer_relationship'
'INV.Forwarding_Bidirectional_Path_CFTE_FEP' return	'INV.Forwarding_Bidirectional_Path_CFTE_FEP'
'INV.is_represented_by_Sk_PM-FEP' return	'INV.is_represented_by_Sk_PM-FEP'
'INV.is_represented_by_Sk_SN-FP' return	'INV.is_represented_by_Sk_SN-FP'
'is_connecting' return	'is_connecting'
'INV.T-M_Source_Connection' return	'INV.T-M_Source_Connection'
'Forwarding_Intermediate_MC' return	'Forwarding_Intermediate_MC'
'Forwarding_Bidirectional_Int_MC' return	'Forwarding_Bidirectional_Int_MC'
'Sn-A_Sink_Connection' return	'Sn-A_Sink_Connection'
'INV.Forwarding_Source_CFTE' return	'INV.Forwarding_Source_CFTE'
'SN-A_Bidirectional_Connection' return	'SN-A_Bidirectional_Connection'
'binds_Sk_SN-FP' return	'binds_Sk_SN-FP'
'Forwarding_Path_LC' return	'Forwarding_Path_LC'
'is_represented_by_Sink_CFTE' return	'is_represented_by_Sink_CFTE'
'Forwarding_to_Intermediate_MC' return	'Forwarding_to_Intermediate_MC'
'binds_So_SN-FP_from' return	'binds_So_SN-FP_from'
'is_represented_by_PM_LC' return	'is_represented_by_PM_LC'
'Forwarding_from_Uni_PM_NC' return	'Forwarding_from_Uni_PM_NC'
'binds_A-FP_from' return	'binds_A-FP_from'
'INV.binds_So_M-FEP_from' return	'INV.binds_So_M-FEP_from'
'Forwarding_from_PM_LC' return	'Forwarding_from_PM_LC'
'is_binding' return	'is_binding'
'is_represented_by_So_SN-FP' return	'is_represented_by_So_SN-FP'
'binds_Sk_PM-FEP_from' return	'binds_Sk_PM-FEP_from'
'/L-A_Source_Connection' return	'/L-A_Source_Connection'
'INV.Forwarding_to_Intermediate_MC' return	'INV.Forwarding_to_Intermediate_MC'
'INV.Forwarding_Bidirectional_Access_Transport_Entity' return	'INV.Forwarding_Bidirectional_Access_Transport_Entity'
'binds_So_L-FP_from' return	'binds_So_L-FP_from'
'Forwarding_Bidirectional_Path_NC' return	'Forwarding_Bidirectional_Path_NC'
'INV.Path-Section_client-server_layer_relationship' return	'INV.Path-Section_client-server_layer_relationship'
'INV.A-A_Bidirectional_Connection' return	'INV.A-A_Bidirectional_Connection'
'INV.is_represented_by_So_L-FP' return	'INV.is_represented_by_So_L-FP'
'INV.is_represented_by_Sk_A-FEP' return	'INV.is_represented_by_Sk_A-FEP'
'site_connects' return	'site_connects'
'is_represented_by_So_M-FEP' return	'is_represented_by_So_M-FEP'
'binds_So_M-FEP_from' return	'binds_So_M-FEP_from'
'IT_is_represented_by' return	'IT_is_represented_by'
'INV.Forwarding_to_Source_MC' return	'INV.Forwarding_to_Source_MC'
'path' return	'path'
'binds_Sk_LPF-FP_to' return	'binds_Sk_LPF-FP_to'
'binds_Sk_PM-FEP' return	'binds_Sk_PM-FEP'
'binds_So_L-FP_to' return	'binds_So_L-FP_to'
'INV.T-L_Sink_Connection' return	'INV.T-L_Sink_Connection'
'INV.binds_So_M-FP_from' return	'INV.binds_So_M-FP_from'
'INV.binds_Sk_PM-FEP_to' return	'INV.binds_Sk_PM-FEP_to'
'INV.Forwarding_Path_NC' return	'INV.Forwarding_Path_NC'
'INV.SN-A_Bidirectional_Connection' return	'INV.SN-A_Bidirectional_Connection'
'is_represented_by_Sink_MC' return	'is_represented_by_Sink_MC'
'INV.is_represented_by_So_AP' return	'INV.is_represented_by_So_AP'
'INV.is_represented_by_Sk_L-FP' return	'INV.is_represented_by_Sk_L-FP'
'INV.Forwarding_from_Uni_PM_NC' return	'INV.Forwarding_from_Uni_PM_NC'
'INV.is_represented_by_So_PM-FEP' return	'INV.is_represented_by_So_PM-FEP'
'Forwarding_Bidirectional_Path_MC_FP' return	'Forwarding_Bidirectional_Path_MC_FP'
'INV./L-A_Source_Connection' return	'INV./L-A_Source_Connection'
'INV.binds_A-FP_to' return	'INV.binds_A-FP_to'
'Forwarding_Bidirectional_Path_LC' return	'Forwarding_Bidirectional_Path_LC'
'is_represented_by_Sk_SN-FP' return	'is_represented_by_Sk_SN-FP'
'INV.binds_So_AP_to' return	'INV.binds_So_AP_to'
'INV.Path-Path_client-server_layer_relationship' return	'INV.Path-Path_client-server_layer_relationship'
'Forwarding_Path_NC' return	'Forwarding_Path_NC'
'Forwarding_to_Source_CFTE' return	'Forwarding_to_Source_CFTE'
'INV.binds_So_LPF-FP' return	'INV.binds_So_LPF-FP'
'INV.Forwarding_to_Source_CFTE' return	'INV.Forwarding_to_Source_CFTE'
'Forwarding_Bidirectional_Access_Transport_Entity' return	'Forwarding_Bidirectional_Access_Transport_Entity'
'INV.T-SN_Source_Connection' return	'INV.T-SN_Source_Connection'
'binding_is_represented_by' return	'binding_is_represented_by'
'binds_Sk_M-FP_to' return	'binds_Sk_M-FP_to'
'Forwarding_Bidirectional_Path_CFTE_FP' return	'Forwarding_Bidirectional_Path_CFTE_FP'
'binds_PM_in_interface' return	'binds_PM_in_interface'
'INV.T-A_Bidirectional_Connection' return	'INV.T-A_Bidirectional_Connection'
'INV.Forwarding_to_End_CFTE' return	'INV.Forwarding_to_End_CFTE'
'INV.Forwarding_PM_NC' return	'INV.Forwarding_PM_NC'
'INV.binds_So_M-FP' return	'INV.binds_So_M-FP'
'LA_-_Bidirectional_Connection' return	'LA_-_Bidirectional_Connection'
'A-T_Bidirectional_Connection' return	'A-T_Bidirectional_Connection'
'A-T_Source_Connection' return	'A-T_Source_Connection'
'binds_Sk_LPF-FEP_from' return	'binds_Sk_LPF-FEP_from'
'is_represented_by_Uni_Path_NC' return	'is_represented_by_Uni_Path_NC'
'binds_So_SN-FP' return	'binds_So_SN-FP'
'Forwarding_Bidirectional_PM_FEP' return	'Forwarding_Bidirectional_PM_FEP'
'Forwarding_PM_NC' return	'Forwarding_PM_NC'
'is_represented_by_Source_MC' return	'is_represented_by_Source_MC'
'T-L_Sink_Connection' return	'T-L_Sink_Connection'
'INV.binds_Sk_SN-FP_to' return	'INV.binds_Sk_SN-FP_to'
'INV.binds_So_AP_from' return	'INV.binds_So_AP_from'
'Path-Section_client-server_layer_relationship' return	'Path-Section_client-server_layer_relationship'
'Forwarding_to_Sink_CFTE' return	'Forwarding_to_Sink_CFTE'
'M-A_Bidirectional_Connection' return	'M-A_Bidirectional_Connection'
'INV.Forwarding_Intermediate_MC' return	'INV.Forwarding_Intermediate_MC'
'binds_So_AP_from' return	'binds_So_AP_from'
'T-SN_Source_Connection' return	'T-SN_Source_Connection'
'INV.binds_So_M-FEP_to' return	'INV.binds_So_M-FEP_to'
'binds_So_LPF-FP' return	'binds_So_LPF-FP'
'T-A_Sink_Connection' return	'T-A_Sink_Connection'
'INV.binds_Sk_A-FEP' return	'INV.binds_Sk_A-FEP'
'INV.Forwarding_Bidirectional_Path_MC_FEP' return	'INV.Forwarding_Bidirectional_Path_MC_FEP'
'INV.Forwarding_Sink_MC' return	'INV.Forwarding_Sink_MC'
'INV.Forwarding_PM_LC' return	'INV.Forwarding_PM_LC'
'is_represented_by_Sk_LPF-FEP' return	'is_represented_by_Sk_LPF-FEP'
'Forwarding_from_Uni_Access_Transport_Entity' return	'Forwarding_from_Uni_Access_Transport_Entity'
'Forwarding_from_Path_LC' return	'Forwarding_from_Path_LC'
'INV.binds_So_M-FEP' return	'INV.binds_So_M-FEP'
'T-A_Source_Connection' return	'T-A_Source_Connection'
'T-L_Bidirectional_Connection' return	'T-L_Bidirectional_Connection'
'binds_Sk_A-FEP' return	'binds_Sk_A-FEP'
'is_represented_by_Intermediate_CFTE' return	'is_represented_by_Intermediate_CFTE'
'INV.is_represented_by_Uni_PM_NC' return	'INV.is_represented_by_Uni_PM_NC'
'binds_Sk_AP' return	'binds_Sk_AP'
'connects' return	'connects'
'INV.is_represented_by_Intermediate_MC' return	'INV.is_represented_by_Intermediate_MC'
'INV.binds_Sk_SN-FP_from' return	'INV.binds_Sk_SN-FP_from'
'INV.T-SN_Sink_Connection' return	'INV.T-SN_Sink_Connection'
'INV.Section-PM_client-server_layer_relationship' return	'INV.Section-PM_client-server_layer_relationship'
'INV.Forwarding_Sink_CFTE' return	'INV.Forwarding_Sink_CFTE'
'is_represented_by_Sk_L-FP' return	'is_represented_by_Sk_L-FP'
'binds_Sk_SN-FEP_to' return	'binds_Sk_SN-FEP_to'
'Forwarding_Unidirectional_Access_Transport_Entity' return	'Forwarding_Unidirectional_Access_Transport_Entity'
'binds_A-FP' return	'binds_A-FP'
'Forwarding_to_Uni_PM_NC' return	'Forwarding_to_Uni_PM_NC'
'interface_connects' return	'interface_connects'
'INV.binds_Sk_M-FP_to' return	'INV.binds_Sk_M-FP_to'
'Forwarding_from_Uni_Path_NC' return	'Forwarding_from_Uni_Path_NC'
'INV.binds_So_SN-FP' return	'INV.binds_So_SN-FP'
'INV.binds_So_LPF-FEP' return	'INV.binds_So_LPF-FEP'
'INV.is_represented_by_Intermediate_CFTE' return	'INV.is_represented_by_Intermediate_CFTE'
'INV.Forwarding_from_Sink_MC' return	'INV.Forwarding_from_Sink_MC'
'INV.binds_Sk_L-FP_to' return	'INV.binds_Sk_L-FP_to'
'INV.binds_Sk_LPF-FEP' return	'INV.binds_Sk_LPF-FEP'
'INV.T-M_Sink_Connection' return	'INV.T-M_Sink_Connection'
'binds_So_SN-FEP' return	'binds_So_SN-FEP'
'INV.binds_Sk_PM-FEP' return	'INV.binds_Sk_PM-FEP'
'INV.binds_Sk_M-FP' return	'INV.binds_Sk_M-FP'
'INV.is_represented_by_A-FP' return	'INV.is_represented_by_A-FP'
'INV.binds_So_M-FP_to' return	'INV.binds_So_M-FP_to'
'INV.is_represented_by_So_LP-FP' return	'INV.is_represented_by_So_LP-FP'
'INV.binds_A-FP_from' return	'INV.binds_A-FP_from'
'INV.A-T_Source_Connection' return	'INV.A-T_Source_Connection'
'INV.is_represented_by_PM_LC' return	'INV.is_represented_by_PM_LC'
'INV.client-server_layer_relationship' return	'INV.client-server_layer_relationship'
'Termination_Function.type' return	'Termination_Function.type'
'has_equipment' return	'has_equipment'
'Forwarding_Bidirectional_Path_CFTE_FEP' return	'Forwarding_Bidirectional_Path_CFTE_FEP'
'INV.Forwarding_Bidirectional_Path_NC' return	'INV.Forwarding_Bidirectional_Path_NC'
'INV.Forwarding_to_Uni_PM_NC' return	'INV.Forwarding_to_Uni_PM_NC'
'INV.is_represented_by_Sk_SN-FEP' return	'INV.is_represented_by_Sk_SN-FEP'
'T-SN_Sink_Connection' return	'T-SN_Sink_Connection'
'binds_So_AP' return	'binds_So_AP'
'INV.Forwarding_Bidirectional_Path_LC' return	'INV.Forwarding_Bidirectional_Path_LC'
'INV.Forwarding_from_Source_MC' return	'INV.Forwarding_from_Source_MC'
'INV.is_represented_by_So_A-FEP' return	'INV.is_represented_by_So_A-FEP'
'INV.Forwarding_to_Uni_Path_NC' return	'INV.Forwarding_to_Uni_Path_NC'
'Forwarding_from_Source_MC' return	'Forwarding_from_Source_MC'
'INV.IT_is_represented_by' return	'INV.IT_is_represented_by'
'INV.is_represented_by_Uni_Access_Transport_Entity' return	'INV.is_represented_by_Uni_Access_Transport_Entity'
'Forwarding_Sink_MC' return	'Forwarding_Sink_MC'
'binds_So_SN-FEP_to' return	'binds_So_SN-FEP_to'
'binds_So_PM-FEP' return	'binds_So_PM-FEP'
'binds' return	'binds'
'binds_So_M-FP' return	'binds_So_M-FP'
'tf_connection' return	'tf_connection'
'T-PM_Source_Connection' return	'T-PM_Source_Connection'
'Forwarding_from_Intermediate_MC' return	'Forwarding_from_Intermediate_MC'
'INV.Forwarding_Unidirectional_Access_Transport_Entity' return	'INV.Forwarding_Unidirectional_Access_Transport_Entity'
'INV.is_represented_by_Sk_LPF-FEP' return	'INV.is_represented_by_Sk_LPF-FEP'
'is_represented_by_Sk_PM-FEP' return	'is_represented_by_Sk_PM-FEP'
'binds_So_M-FP_to' return	'binds_So_M-FP_to'
'diff' return 'diff'
'same' return 'same'

/* Attributes */
'location'		return 'location'
'type'			return 'type'

'lat.deg'		return 'lat.deg'
'lat.min'		return 'lat.min'
'lat.sec'		return 'lat.sec'

'lon.deg'		return 'lon.deg'
'lon.min'		return 'lon.min'
'lon.sec'		return 'lon.sec'

/* Language constraints */
':'				return 'colon'
'.'				return 'dot'
';'				return 'semicolon'
'='				return 'equal'
','				return 'comma'
'{'				return 'l_curly_bracket'
'}'				return 'r_curly_bracket'
'('				return 'l_parenthesis'
')'				return 'r_parenthesis'

('-')?[0-9]+	return 'graus'
[A-Za-z_]+[0-9A-Za-z_]* return 'variable'
[0-9]+					return 'n_int'

"/*"(.|\n|\r)*?"*/"  /* ignore */           
<<EOF>>         return 'EOF'
.				return 'INVALID'

/lex


%start expressions

%% /* language grammar */

expressions
    : Instruction  EOF | Instruction  expressions
    ;
	
variable_declaration:
	variable | (variable comma  variable_declaration)
;

Instruction:
IndividualDeclaration | AttributeDeclaration | RelationDeclaration | DifferentFromDeclaration | SameAsDeclaration
;

IndividualDeclaration:
(Classes colon variable_declaration semicolon)
;

AttributeDeclaration:
	TypeDeclaration | LocationDeclaration | CoordinateDeclaration
;

TypeDeclaration:
	variable dot type colon variable semicolon
;

LocationDeclaration:
	variable dot location colon variable semicolon
;

CoordinateDeclaration:
(variable dot lat.deg colon graus semicolon) | 
(variable dot lat.min colon graus semicolon) | 
(variable dot lat.sec colon graus semicolon) | 

(variable dot lon.deg colon graus semicolon) | 
(variable dot lon.min colon graus semicolon) | 
(variable dot lon.sec colon graus semicolon)
;

RelationDeclaration:
	variable Relation variable_declaration semicolon
;

DifferentFromDeclaration:
	variable diff variable_declaration semicolon
;

SameAsDeclaration:
	variable same variable_declaration semicolon
;


/*-------------------------------------------------------------*/



Classes:
'Source_PM-FEP_Binding'
 | 'Bound_Input_Interface_PM'
 | 'Bidirectional_Access_Transport_Entity'
 | 'Uni_Subnetwork_-_A_So_Connected'
 | 'Output_Interface'
 | 'Source_LPF-FEP'
 | 'Source_Matrix'
 | 'T_So_Input_-_So_AP_Bound'
 | 'Sk_Matrix_Bi_Component'
 | 'Bi_Path_CFTE'
 | 'A_Sk_Output_-_Sk_LPF-FP_Bound'
 | 'Unidirectional_A-FP'
 | 'Physical_Media_Input'
 | 'Active_Sk_PM-FEP_-_PM_NC_connected'
 | 'Connected_Output_Interface'
 | 'Source_M-FP_Bi_Component'
 | 'Adaptation_Sink_Process'
 | 'Forwarding_End_Point'
 | 'Termination_Source_-_LPF_Connected'
 | 'A_Sk_Output_-_Sk_SN-FP_Bound'
 | 'Sink_CFTE_Bi_Component'
 | 'T_So_Output_-_So_A-FEP_Bound'
 | 'Adaptation_Sink'
 | 'Binding'
 | 'SN_-_Termination_Sink_Connected'
 | 'Bi_PM_LC'
 | 'Sink_LP-FP'
 | 'Forwarding_Function_So_M_Connected'
 | 'Topological_SN_Representation'
 | 'Sink_PM-FEP'
 | 'Sink_Site'
 | 'Egress_SN_So'
 | 'Active_Intermediate_Bidirectional_SN-FP'
 | 'Source_CFTE'
 | 'A_So_Output_-_So_AP_Bound'
 | 'Access_Point'
 | 'SN_Input_-_So_S-FEP_Bound'
 | 'Source_MC'
 | 'Bidirectional_AP'
 | 'Bound_Output_Interface'
 | 'Adaptation_Sink_Output'
 | 'Bound_Transport_Function'
 | 'Physical_Media_Output'
 | 'Bidirectional_PM-FEP'
 | 'Active_Sk_SN-FP_-_Int_CFTE_connected'
 | 'Active_So_M-FP_-_So_MC_connected'
 | 'Forwarding_Function_LC_'
 | 'Forwarding_Rule_MC_Sk-So'
 | 'PM_LC'
 | 'LPF_So_Bidirectional_Component'
 | 'Source_M-FEP_Binding'
 | 'Sink_SN-FEP'
 | 'Unidirectional_PM_NC'
 | 'Matrix_Connection'
 | 'Sink_SN-FP'
 | 'Source_SN-FP_Binding'
 | 'Source_AP_Bi_Component'
 | 'A_So_-_Uni_Matrix_Connected'
 | 'Bidirectional_Path_FEP'
 | 'Uni_Sk-So_Matrix_Bi_Component'
 | 'Access_Group'
 | 'Egress_MC_Sk'
 | 'LPF_-_Termination_Source_Connected_'
 | 'Geographical_Element_With_Alias'
 | 'Adaptation_Sink_-_T_Sk_Connected'
 | 'Fowarding_Rule_Sk_SN'
 | 'LPF_Input_-_Sk_LPF-FP_Bound'
 | 'So_CFTE_Forwarding'
 | 'Sink_LPF-FEP_Binding'
 | 'Sink_SN-FEP_Binding'
 | 'PM_-_Termination_Sink_Connected'
 | 'SN-FP'
 | 'Intermediate_CFTE'
 | 'Active_Sk_M-FP_-_Int_MC_connected'
 | 'Sink_LPF-FEP_Bi_Component'
 | 'Equipment'
 | 'Adaptation_Sink_-_A_So_Connected'
 | 'Access_Transport_Entity'
 | 'LC_Composed_Layer_Network'
 | 'Intermediate_CFTE_Bi_Component'
 | 'So_Matrix_Bi_Component'
 | 'Forwarding_Function_CFTE_Sk'
 | 'Egress_LC'
 | 'Layer_Network'
 | 'Path_Layer_Termination'
 | 'Bidirectional_Sink-Source_Matrix'
 | 'Ingress_SN_Sk'
 | 'Equipment_Site_Component'
 | 'Termination_Sink_Input'
 | 'Bi_Intermediate_MC'
 | 'Active_End_Bidirectional_SN-FEP'
 | 'Path_Bidirectional_Matrix'
 | 'A_Sk_Output_-_Sk_M-FP_Bound'
 | 'Input'
 | 'M_Output_-_Sk_M-FEP_Bound'
 | 'Source_M-FP'
 | 'Egress_MC_Sk-So'
 | 'Ingress_LC'
 | 'A_Sk_Output_-_Sk_LP-FP_Bound'
 | 'Active_Sk_PM-FEP_-_PM_LC_connected'
 | 'Active_So_M-FEP_-_So_MC_connected'
 | 'Directly_Bound_Reference_Point'
 | 'Adaptation_Sk_Bidirectional_Component'
 | 'PM_-_Termination_Source_Connected'
 | 'A_Sk_-_Uni_Subnetwork_Connected'
 | 'Adaptation_Source_Input'
 | 'Transmission_Media_Layer_Network'
 | 'Bound__Output_Interface_Equipment'
 | 'Layer_Processor_Sink_Output'
 | 'Source_SN-FP_Bi_Component'
 | 'Connected_Unidirectional_Matrix'
 | 'Bidirectional_Termination_-_Bi_M_Connected'
 | 'Supporting_LC'
 | 'Sink_CFTE'
 | 'Source_AP'
 | 'Termination_Sink_Output'
 | 'Layer_Processor_Source_Output'
 | 'T_Sk_Input_-_Sk_M-FEP_Bound'
 | 'Topological_Layer'
 | 'NC_Supported_by_CFTE'
 | 'Sink_LPF-FEP'
 | 'Possible_Bi_LC_Connected_RP'
 | 'Matrix_Input'
 | 'Source_SN-FEP_Bi_Component'
 | 'Bidirectional_LPF_-_Bi_Termination_Connected'
 | 'Sink_M-FEP'
 | 'Sink_SN-FP_Bi_Component'
 | 'LPF_Output_-_So_L-FP_Bound'
 | 'Bidirectional_M-FEP'
 | 'Bidirectional_MC'
 | 'Connected_Relatable_TC'
 | 'Source_M-FEP_Bi_Component'
 | 'Composed_Topological_Layer'
 | 'Transport_Funtion_Equipment_Component'
 | 'Section_Layer_Network'
 | 'Bidirectional_Adaptation_-_LPF_Bi_Connected'
 | 'Reference_Point'
 | 'Geographical_Element'
 | 'Termination_So_Bidirectional_Component'
 | 'Bi_Subnetwork_-_A_Bi_Connected'
 | 'Bidirectional_Termination_-_Ag_PM_Connected'
 | 'Layer_Processor_Function'
 | 'M_-_Termination_Source_Connected'
 | 'Forwarding_Function_CFTE_Sk-So'
 | 'A_So_Input_-_A-FP_Bound'
 | 'Bound_Input_Interface'
 | 'Termination_Sk_Bidirectional_Component'
 | 'Source_PM-FEP_Bi_Component'
 | 'T_Sk_Input_-_Sk_SN-FEP_Bound'
 | 'Unidirectional_Access_Transport_Entity_Bidirectional_Component'
 | 'M_Input_-_Sk_M-FP_Bound'
 | 'Forwarding_Rule_MC_So'
 | 'Directly_Connected_Transport_Entity'
 | 'Sk_MC_Forwarding'
 | 'Equipment_Composed_Site'
 | 'Bidirectional_Layer_Processor_-_A_Bi_Connected'
 | 'A_So_Input_-_So_SN-FP_Bound'
 | 'Forwarding_Rule_LC'
 | 'Source_M-FP_Binding'
 | 'Uni_Matrix_-_A_So_Connected'
 | 'A_-_Layer_Processor_Sink_Connected'
 | 'Sink_LPF-FEP_Bound'
 | 'Forwarding_Function_CFTE_So-Sk'
 | 'Section_Layer_Termination'
 | 'LPF_-_Termination_Sink_Connected'
 | 'Layer_Processor_Function_Source'
 | 'Supporting_Access_Transport_Entity'
 | 'Input_Interface'
 | 'Source_Active_RP_-_Path_LC_connected'
 | 'Bidirectional_Adaptation_-_Bi_A_Connected'
 | 'Bound_Input-Output'
 | 'Component_Subnetwork'
 | 'T_Sk_Input_-_Sk_A-FEP_Bound'
 | 'Client_Path_Layer'
 | 'Path-Path_Client_Layer'
 | 'Bidirectional_SN-FP'
 | 'Bidirectional_Layer_Processor_Function'
 | 'Bidirectional_PM_NC'
 | 'Uni_Subnetwork_-_A_Sk_Connected'
 | 'Bidirectional_Adaptation'
 | 'Source_SN-FEP'
 | 'T_So_Output_-_So_SN-FEP_Bound'
 | 'Bi_A_-_Bidirectional_Termination_Connected'
 | 'Sink_MC'
 | 'Path-Path_Layers_AF'
 | 'Unidirectional_Sink-Source_Matrix'
 | 'NC_Supported_by_MC'
 | 'A-FP'
 | 'End_CFTE_Bi_Component'
 | 'A_Sk_Output_-_Sk_A-FEP_Bound'
 | 'Forwarding_Rule_So_SN'
 | 'Physical_Media_Layer_Termination'
 | 'Active_Bidirectional_Path_FEP_-_Path_NC_Connected'
 | 'Mapped_Input_Interface'
 | 'A_So_Input_-_So_LPF-FP_Bound'
 | 'Unidirectional_MC'
 | 'Termination_Sink_Process'
 | 'Sink_FEP'
 | 'Forwarding_Function_Matrix'
 | 'Layer_Processor_Source_Process'
 | 'Layer_Processor_Source_-_A_Connected'
 | 'AP_Forwarding'
 | 'Active_Bidirectional_PM-FEP_-_PM_NC_Connected'
 | 'Forwarding_Function_Sk-So_Connected'
 | 'Active_Sink_AP'
 | 'Bi_Path_MC'
 | 'Source_L-FP_Binding'
 | 'Unidirectional_Path_NC_Bidirectional_Component'
 | 'Ag_PM_-_Bidirectional_Termination_Connected'
 | 'LP_Input_-_Sk_LP-FP_Bound'
 | 'Active_So_M-FP_-_Int_MC_connected'
 | 'Topological_M_Representation'
 | 'Source_A-FEP_Bi_Component'
 | 'M_-_Termination_Sink_Connected'
 | 'Termination_Source_-_M_Connected'
 | 'Bi_End_CFTE'
 | 'Transmission_Media_Layer_Termination'
 | 'Sk_CFTE_Forwarding'
 | 'Matrix_Output'
 | 'A_So_-_Uni_Subnetwork_Connected'
 | 'T_Sk_Input_-_Sk_PM-FEP_Bound'
 | 'Sink_M-FP'
 | 'Path_Connected_Reference_Point'
 | 'Possible_Egress_LC'
 | 'PM_LC_Bi_Component'
 | 'A-FP_Binding'
 | 'Single_Equipment_Site_Component'
 | 'Forwarding_Rule_Sk-So'
 | 'Active_Sk_M-FEP_-_Sk_MC_connected'
 | 'Source_CFTE_Bi_Component'
 | 'Source_FEP'
 | 'Bidirectional_Termination_-_Bi_LPF_Connection'
 | 'Termination_Source_-_PM_Connected'
 | 'Termination_Source_Input'
 | 'Termination_Sink_-_A_Sk_Connected'
 | 'Sink_M-FP_Binding'
 | 'Mapped_TF_Input'
 | 'Client_Section_Layer'
 | 'Network_Connection'
 | 'Sink_M-FEP_Binding'
 | 'Bidirectional_NC'
 | 'Active_So_Path-FEP_-_Path_NC_connected'
 | 'Sink_MC_Bi_Component'
 | 'Source_LP-FP'
 | 'Supporting_NC'
 | 'Source_LP-FP_Binding'
 | 'Termination_Source_Process'
 | 'Source_AP_Binding'
 | 'Adaptation_Source'
 | 'PM_Input_-_So_PM-FEP_Bound'
 | 'Related_Layer_Network'
 | 'Adaptation_Source_Process'
 | 'Termination_Sink_-_M_Connected'
 | 'LP-FP'
 | 'Possible_LC_Connected_RP'
 | 'Egress_MC_So'
 | 'Source_MC_Bi_Component'
 | 'Uni_A-FP_Bi_Component'
 | 'SN_Intput_-_Sk_SN-FP_Bound'
 | 'Transport_Function'
 | 'SN_Outtput_-_So_SN-FP_Bound'
 | 'Site'
 | 'Section-Physical_Media_Layers_AF'
 | 'Forwarding'
 | 'Int_MC_Forwarding'
 | 'Termination_Source'
 | 'Forwarding_Function_CFTE_So'
 | 'Physical_Media_Layer_Network'
 | 'Layer_Processor_Sink_Input'
 | 'Intermediate_MC'
 | 'Active_Intermediate_Bidirectional_M-FP'
 | 'Ingress_SN_So'
 | 'Matrix'
 | 'Layer_Processor_Source_Input'
 | 'Bidirectional_M-FP'
 | 'Active_Sk_Path-FEP_-_Path_NC_connected'
 | 'Sink_PM-FEP_Binding'
 | 'Layer_Processor_Process'
 | 'Topological_Subnetwork'
 | 'Active_Bidirectional_PM-FEP_-_PM_LC_Connected'
 | 'A_So_-_Adaptation_Sink_Connected'
 | 'Output'
 | 'Adaptation_Sink_Input'
 | 'Sink_AP_Binding'
 | 'Termination_Sink_-_PM_Connected'
 | 'Sink_Matrix'
 | 'Bidirectional_LC'
 | 'Termination_Function'
 | 'Source_M-FEP'
 | 'Bidirectional_LPF-FEP'
 | 'Possible_Ingress_LC'
 | 'Bidirectional_A-FP'
 | 'So_MC_Forwarding'
 | 'Path_Layer_Network'
 | 'LC_Connected_RP'
 | 'T_So_Output_-_So_M-FEP_Bound'
 | 'Connected_Reference_Point'
 | 'Source_LPF-FEP_Bi_Component'
 | 'Composed_AG'
 | 'Sink_AP'
 | 'M_Output_-_So_M-FP_Bound'
 | 'Sink_Active_RP_-_Path_LC_connected'
 | 'Relatable_Topological_Components'
 | 'Termination_Sink_-_LPF_Connected'
 | 'Mapped_Output_Interface'
 | 'Layer_Processor_Function_Sink'
 | 'Sink_Path_FEP'
 | 'Bi_Termination_-_Bidirectional_A_Connected'
 | 'Unidirectional_Matrix'
 | 'Termination_Source_Output'
 | 'Architectural_Component'
 | 'Forwarding_Rule'
 | 'Bidirectional_Path_NC'
 | 'A_So_Input_-_So_A-FEP_Bound'
 | 'Sink_AP_Bi_Component'
 | 'Active_So_PM-FEP_-_PM_LC_connected'
 | 'Component_Matrix'
 | 'Composed_PM_Layer'
 | 'Termination_Source_-_SN_Connected'
 | 'Unidirectional_PM_NC_Bidirectional_Component'
 | 'Bidirectional_FEP'
 | 'Unidirectional_NC'
 | 'Sink_A-FEP_Bi_Component'
 | 'PM_Output_-_Sk_PM-FEP_Bound'
 | 'Forwarding_Function_CFTE'
 | 'Termination_Source_-_A_So_Connected'
 | 'Active_Bidirectional_AP'
 | 'PM_Interface_Bound_Input'
 | 'Supporting_CFTE'
 | 'Bi_M_-_Bidirectional_Termination_Connected'
 | 'PM_LC_Forwarding'
 | 'Bidirectional_LP-FP'
 | 'Server_Physical_Media_Layer'
 | 'Mapped_TF_Output'
 | 'Ingress_SN_Sk-So'
 | 'Physical_Media_Component'
 | 'Ingress_MC_Sk'
 | 'LPF_Output_-_So_LPF-FP_Bound'
 | 'Sink_A-FEP_Binding'
 | 'TE_Connected_Reference_Point'
 | 'Active_Path_Bidirectional_SN-FP'
 | 'Active_Sk_SN-FEP_-_Sk_CFTE_connected'
 | 'Egress_SN_Sk-So'
 | 'Unidirectional_Port'
 | 'Unidirectional_Subnetwork'
 | 'Forwarding_Rule_So-Sk'
 | 'LPF_Input_-_So_L-FEP_Bound'
 | 'T_So_-_Adaptation_Source_Connected'
 | 'Bidirectional_SN-FEP'
 | 'Single_AG'
 | 'NC_Supported_by_LC'
 | 'Active_Path_Bidirectional_M-FP'
 | 'M-FP'
 | 'Unidirectional_Path_NC'
 | 'T_Sk_Input_-_Sk_LPF-FEP_Bound'
 | 'Active_Sk_M-FP_-_Sk_MC_connected'
 | 'Adaptation_So_Bidirectional_Component'
 | 'Source_LP-FP_Bi_Component'
 | 'A_Sk_Input_-_Sk_AP_Bound'
 | 'Single_Termination'
 | 'Bi_A_-_Bi_Matrix_Connected'
 | 'Adaptation_Function'
 | 'Unidirectional_LC'
 | 'A_-_LPF_Source_Connected'
 | 'Subnetwork'
 | 'Active_So_SN-FEP_-_So_CFTE_connected'
 | 'Forwarding_Function_LC_Connected'
 | 'Sink_M-FP_Bi_Component'
 | 'Path-Section_Layers_AF'
 | 'Unidirectional_Access_Transport_Entity'
 | 'Bidirectional_Termination_-_Bi_SN_Connected'
 | 'Bidirectional_Termination_-_Bi_A_Connected'
 | 'Subnetwork_Input'
 | 'Connected_Input_Interface'
 | 'Egress_SN_Sk'
 | 'Bi_Matrix_-_A_Bi_Connected'
 | 'Forwarding_Function'
 | 'Ingress_MC_Sk-So'
 | 'T_So_Output_-_So_LPF-FEP_Bound'
 | 'Multiple_Equipment_Composed_Site'
 | 'Source_Path_FEP'
 | 'Site_Component_Equipment'
 | 'Active_So_SN-FP_-_Int_CFTE_connected'
 | 'Active_Sk_SN-FEP_-_End_CFTE_connected'
 | 'Layer_Processor_Sink_-_A_Connected'
 | 'Bidirectional_Connected_Subnetwork'
 | 'Active_Sk_SN-FP_-_Sk_CFTE_connected'
 | 'Source_Site'
 | 'PM_NC_Forwarding'
 | 'Server_Path_Layer'
 | 'Matrix_Composed_Path_Layer'
 | 'Bi_Intermediate_CFTE'
 | 'Source_A-FEP'
 | 'End_CFTE'
 | 'Co-located_Termination'
 | 'Sink_LP-FP_Bi_Component'
 | 'Bi_SN_-_Bidirectional_Termination_Connected'
 | 'T_So_Output_-_So_PM-FEP_Bound'
 | 'Int_CFTE_Forwarding'
 | 'Active_Possible_Bi_LC_Connected_RP'
 | 'Intermediate_MC_Bi_Component'
 | 'Adaptation_Source_-_T_So_Connected'
 | 'Source_LPF-FEP_Binding'
 | 'Ingress_SN_So-Sk'
 | 'LPF_Sk_Bidirectional_Component'
 | 'A_Sk_-_Uni_Matrix_Connected'
 | 'Aggregated_Physical_Media'
 | 'Supporting_MC'
 | 'Source_SN-FEP_Binding'
 | 'Sink_SN-FEP_Bi_Component'
 | 'Bidirectional_Matrix'
 | 'SN_Output_-_Sk_S-FEP_Bound'
 | 'T_Sk_-_Adaptation_Sink_Connected'
 | 'Sink_LP-FP_Binding'
 | 'Topological_Component'
 | 'Adaptation_Source_Output'
 | 'Termination_Sink'
 | 'Topological_Link'
 | 'Termination_Sink_-_SN_Connected'
 | 'Physical_Media'
 | 'Path_LC'
 | 'Bidirectional_CFTE'
 | 'Subnetwork_Output'
 | 'Active_Source_AP'
 | 'Transport_Entity'
 | 'Path-Section_Client_Layer'
 | 'Forwarding_Rule_MC_Sk'
 | 'A_Sk_Output_-_A-FP_Bound'
 | 'Bidirectional_Termination'
 | 'A_Sk_-_Termination_Sink_Connected'
 | 'A_So_Input_-_So_M-FP_Bound'
 | 'M_Input_-_So_M-FEP_Bound'
 | 'Link_Connection'
 | 'Bidirectional_Adaptation_-_Bi_T_Connected'
 | 'Sink_SN-FP_Binding'
 | 'Uni_Matrix_-_A_Sk_Connected'
 | 'Source_A-FEP_Binding'
 | 'Subnetwork_Composed_Path_Layer'
 | 'Bound_Input_Interface_Equipment'
 | 'Transport_Processing_Function'
 | 'Bidirectional_A-FEP'
 | 'Active_So_SN-FP_-_So_CFTE_connected'
 | 'Source_PM-FEP'
 | 'Sink_A-FEP'
 | 'Single_Equipment_Site'
 | 'Forwarding_Function_Sk_M_Connected'
 | 'Bound_Output_Interface_PM'
 | 'Active_So_PM-FEP_-_PM_NC_connected'
 | 'End_Forwarding'
 | 'SN_-_Termination_Source_Connected'
 | 'Path_LC_Forwarding'
 | 'Physical_Media_Layer_Component'
 | 'Source_SN-FP'
 | 'Ingress_MC_So'
 | 'PM_Interface_Bound_Output'
 | 'Unidirectional_CFTE'
 | 'A_So_-_Termination_Source_Connected'
 | 'Sink_PM-FEP_Bi_Component'
 | 'Bi_Path_LC'
 | 'Sink_M-FEP_Bi_Component'
 | 'Active_Path_Bidirectional_M-FEP'
 | 'A_So_Input_-_So_L-FP_Bound'
 | 'Defined_Geographical_Element'
 | 'Single_Physical_Media'
 | 'Bi_A_-_Bi_Subnetwork_Connected'
 | 'Forwarding_Point'
 | 'Component_LPF'
 | 'Active_So_SN-FEP_-_End_CFTE_connected'
 | 'Active_Path_Bidirectional_SN-FEP'
 | 'Channel_Forwarding_Transport_Entity'
 | 'T_Sk_Output_-_Sk_AP_Bound'
 | 'Path_LC_Bi_Component'
 | 'LPF_-_Sk_L-FEP_Bound'
 | 'Server_Section_Layer'
;

Relation:
'binds_So_L-FP'
 | 'INV.set_egress'
 | 'componentOf'
 | 'supports'
 | 'INV.componentOf'
 | 'is_configured_by'
 | 'INV.represents'
 | 'INV.memberOf'
 | 'is_defined_by'
 | 'set_ingress'
 | 'INV.set_ingress'
 | 'represents'
 | 'INV.is_defined_by'
 | 'INV.is_configured_by'
 | 'INV.supports'
 | 'set_egress'
 | 'INV.binds_So_L-FP'
 | 'memberOf'
 | 'INV.is_defined_by.Forwarding_Rule_Sk-So.Forwarding_Function_CFTE_Sk-So'
 | 'is_defined_by.Forwarding_Rule_So-Sk.Forwarding_Function_CFTE_So-Sk'
 | 'componentOf.Bidirectional_Access_Transport_Entity.Unidirectional_Access_Transport_Entity_Bidirectional_Component'
 | 'componentOf.Bi_Path_LC.Path_LC_Bi_Component'
 | 'INV.set_ingress.Forwarding_Rule_MC_So.Ingress_MC_So'
 | 'INV.componentOf.Equipment.Input_Interface'
 | 'INV.componentOf.Equipment.Output_Interface'
 | 'INV.componentOf.Bidirectional_Access_Transport_Entity.Unidirectional_Access_Transport_Entity_Bidirectional_Component'
 | 'componentOf.Bidirectional_AP.Source_AP_Bi_Component'
 | 'set_egress.Forwarding_Rule_Sk-So.Egress_SN_Sk-So'
 | 'INV.componentOf.Topological_Layer.Access_Group'
 | 'INV.binds_So_L-FP.LP_Input_-_Sk_LP-FP_Bound.A_Sk_Output_-_Sk_LP-FP_Bound'
 | 'set_ingress.Forwarding_Rule_Sk-So.Ingress_SN_Sk-So'
 | 'componentOf.Unidirectional_Subnetwork.Subnetwork_Input'
 | 'INV.componentOf.Single_Physical_Media.Physical_Media_Output'
 | 'componentOf.Adaptation_Sink.Adaptation_Sink_Process'
 | 'represents.Topological_Layer.Layer_Network'
 | 'is_configured_by.Sk_MC_Forwarding.Forwarding_Function_Sk_M_Connected'
 | 'componentOf.Composed_Topological_Layer.Connected_Relatable_TC'
 | 'componentOf.Layer_Processor_Function_Source.Layer_Processor_Source_Output'
 | 'componentOf.Adaptation_Source.Adaptation_Source_Input'
 | 'INV.set_egress.Forwarding_Rule_Sk-So.Egress_SN_Sk-So'
 | 'INV.componentOf.Bi_End_CFTE.End_CFTE_Bi_Component'
 | 'componentOf.Termination_Sink.Termination_Sink_Process'
 | 'componentOf.Bidirectional_LP-FP.Sink_LP-FP_Bi_Component'
 | 'set_ingress.Forwarding_Rule_MC_So.Ingress_MC_So'
 | 'INV.is_configured_by.Int_CFTE_Forwarding.Forwarding_Function_CFTE_Sk-So'
 | 'set_ingress.Forwarding_Rule_So_SN.Ingress_SN_So'
 | 'componentOf.Single_Physical_Media.Physical_Media_Output'
 | 'componentOf.Bidirectional_LP-FP.Source_LP-FP_Bi_Component'
 | 'INV.componentOf.LC_Composed_Layer_Network.Link_Connection'
 | 'binds_So_L-FP.LP_Input_-_Sk_LP-FP_Bound.A_Sk_Output_-_Sk_LP-FP_Bound'
 | 'represents.Single_Equipment_Site.Single_Equipment_Site_Component'
 | 'INV.componentOf.Bidirectional_SN-FP.Source_SN-FP_Bi_Component'
 | 'INV.componentOf.Bidirectional_A-FP.Uni_A-FP_Bi_Component'
 | 'INV.componentOf.Bidirectional_Termination.Termination_So_Bidirectional_Component'
 | 'INV.componentOf.Bidirectional_M-FP.Sink_M-FP_Bi_Component'
 | 'INV.is_configured_by.So_CFTE_Forwarding.Forwarding_Function_CFTE_So'
 | 'INV.componentOf.Path_Bidirectional_Matrix.Sk_Matrix_Bi_Component'
 | 'componentOf.Physical_Media_Layer_Network.Physical_Media_Layer_Termination'
 | 'represents.Topological_Link.Link_Connection'
 | 'INV.componentOf.Unidirectional_Subnetwork.Subnetwork_Output'
 | 'INV.componentOf.Bidirectional_LPF-FEP.Sink_LPF-FEP_Bi_Component'
 | 'componentOf.Composed_PM_Layer.Physical_Media_Layer_Component'
 | 'supports.Supporting_Access_Transport_Entity.Path_LC'
 | 'INV.componentOf.Termination_Source.Termination_Source_Input'
 | 'componentOf.Bi_Path_MC.Sink_MC_Bi_Component'
 | 'componentOf.Unidirectional_Subnetwork.Subnetwork_Output'
 | 'INV.componentOf.Bidirectional_M-FEP.Source_M-FEP_Bi_Component'
 | 'INV.is_configured_by.End_Forwarding.Forwarding_Function_CFTE_So-Sk'
 | 'componentOf.Adaptation_Source.Adaptation_Source_Process'
 | 'componentOf.Adaptation_Sink.Adaptation_Sink_Input'
 | 'INV.componentOf.Bi_Path_CFTE.Sink_CFTE_Bi_Component'
 | 'INV.represents.Topological_Link.Link_Connection'
 | 'componentOf.Bidirectional_SN-FEP.Source_SN-FEP_Bi_Component'
 | 'INV.represents.Single_AG.Single_Termination'
 | 'componentOf.Bidirectional_Layer_Processor_Function.LPF_So_Bidirectional_Component'
 | 'memberOf.Aggregated_Physical_Media.Physical_Media_Component'
 | 'INV.componentOf.Bi_Path_MC.Source_MC_Bi_Component'
 | 'INV.set_egress.Fowarding_Rule_Sk_SN.Egress_SN_Sk'
 | 'INV.is_defined_by.Int_MC_Forwarding.Forwarding_Rule_MC_Sk-So'
 | 'INV.componentOf.Bidirectional_Adaptation.Adaptation_Sk_Bidirectional_Component'
 | 'componentOf.Subnetwork_Composed_Path_Layer.Component_Subnetwork'
 | 'INV.componentOf.Bidirectional_A-FEP.Sink_A-FEP_Bi_Component'
 | 'INV.supports.Supporting_NC.Access_Transport_Entity'
 | 'INV.memberOf.Aggregated_Physical_Media.Physical_Media_Component'
 | 'INV.componentOf.Bidirectional_M-FP.Source_M-FP_Bi_Component'
 | 'INV.componentOf.Bidirectional_Adaptation.Adaptation_So_Bidirectional_Component'
 | 'componentOf.Bidirectional_M-FEP.Source_M-FEP_Bi_Component'
 | 'componentOf.Single_Physical_Media.Physical_Media_Input'
 | 'componentOf.Multiple_Equipment_Composed_Site.Equipment_Site_Component'
 | 'INV.is_defined_by.Forwarding_Rule_MC_Sk.Sk_MC_Forwarding'
 | 'set_egress.Forwarding_Rule_So_SN.Egress_SN_So'
 | 'INV.supports.Supporting_CFTE.NC_Supported_by_CFTE'
 | 'INV.binds_So_L-FP.LPF_Output_-_So_L-FP_Bound.A_So_Input_-_So_L-FP_Bound'
 | 'INV.represents.Topological_M_Representation.Matrix'
 | 'componentOf.Bidirectional_LPF-FEP.Source_LPF-FEP_Bi_Component'
 | 'INV.componentOf.Bidirectional_A-FEP.Source_A-FEP_Bi_Component'
 | 'set_ingress.Forwarding_Rule_MC_Sk-So.Ingress_MC_Sk-So'
 | 'componentOf.Bi_End_CFTE.End_CFTE_Bi_Component'
 | 'componentOf.Bidirectional_SN-FP.Sink_SN-FP_Bi_Component'
 | 'represents.Single_AG.Single_Termination'
 | 'supports.Supporting_CFTE.NC_Supported_by_CFTE'
 | 'INV.componentOf.Bidirectional_PM-FEP.Source_PM-FEP_Bi_Component'
 | 'componentOf.Bidirectional_Path_NC.Unidirectional_Path_NC_Bidirectional_Component'
 | 'INV.componentOf.Unidirectional_Subnetwork.Subnetwork_Input'
 | 'INV.componentOf.Matrix_Composed_Path_Layer.Component_Matrix'
 | 'componentOf.Termination_Source.Termination_Source_Process'
 | 'INV.componentOf.Bidirectional_Layer_Processor_Function.LPF_So_Bidirectional_Component'
 | 'is_configured_by.Int_MC_Forwarding.Forwarding_Function_Sk-So_Connected'
 | 'INV.set_egress.Forwarding_Rule_MC_Sk-So.Egress_MC_Sk-So'
 | 'INV.represents.Topological_SN_Representation.Subnetwork'
 | 'INV.componentOf.Bidirectional_Path_NC.Unidirectional_Path_NC_Bidirectional_Component'
 | 'componentOf.Termination_Sink.Termination_Sink_Output'
 | 'INV.is_configured_by.Sk_MC_Forwarding.Forwarding_Function_Sk_M_Connected'
 | 'set_ingress.Fowarding_Rule_Sk_SN.Ingress_SN_Sk'
 | 'componentOf.Bidirectional_Adaptation.Adaptation_Sk_Bidirectional_Component'
 | 'INV.componentOf.Bidirectional_AP.Sink_AP_Bi_Component'
 | 'INV.componentOf.Adaptation_Sink.Adaptation_Sink_Process'
 | 'INV.componentOf.Bidirectional_SN-FEP.Source_SN-FEP_Bi_Component'
 | 'componentOf.Layer_Processor_Function_Source.Layer_Processor_Source_Input'
 | 'supports.Supporting_NC.Access_Transport_Entity'
 | 'INV.componentOf.Composed_PM_Layer.Physical_Media_Layer_Component'
 | 'INV.set_egress.Forwarding_Rule_MC_Sk.Egress_MC_Sk'
 | 'INV.supports.Supporting_LC.NC_Supported_by_LC'
 | 'INV.componentOf.Bidirectional_PM-FEP.Sink_PM-FEP_Bi_Component'
 | 'INV.is_configured_by.Int_MC_Forwarding.Forwarding_Function_Sk-So_Connected'
 | 'INV.set_ingress.Forwarding_Rule_MC_Sk-So.Ingress_MC_Sk-So'
 | 'componentOf.Bidirectional_A-FEP.Source_A-FEP_Bi_Component'
 | 'INV.componentOf.Layer_Processor_Function_Sink.Layer_Processor_Sink_Output'
 | 'componentOf.Bidirectional_M-FEP.Sink_M-FEP_Bi_Component'
 | 'componentOf.Bi_Intermediate_CFTE.Intermediate_CFTE_Bi_Component'
 | 'componentOf.Bidirectional_Layer_Processor_Function.LPF_Sk_Bidirectional_Component'
 | 'is_configured_by.Int_CFTE_Forwarding.Forwarding_Function_CFTE_Sk-So'
 | 'INV.componentOf.Path_Layer_Network.Component_LPF'
 | 'set_ingress.Forwarding_Rule_LC.Ingress_LC'
 | 'INV.represents.Composed_AG.Co-located_Termination'
 | 'INV.componentOf.Adaptation_Source.Adaptation_Source_Output'
 | 'componentOf.Bidirectional_LPF-FEP.Sink_LPF-FEP_Bi_Component'
 | 'INV.componentOf.Path_Bidirectional_Matrix.So_Matrix_Bi_Component'
 | 'componentOf.Adaptation_Sink.Adaptation_Sink_Output'
 | 'INV.componentOf.Bi_Intermediate_CFTE.Intermediate_CFTE_Bi_Component'
 | 'INV.componentOf.Termination_Source.Termination_Source_Output'
 | 'set_egress.Forwarding_Rule_MC_Sk.Egress_MC_Sk'
 | 'is_defined_by.Forwarding_Rule_MC_So.Forwarding_Function_So_M_Connected'
 | 'INV.set_ingress.Forwarding_Rule_Sk-So.Ingress_SN_Sk-So'
 | 'set_egress.Forwarding_Rule_So-Sk.Egress_SN_Sk-So'
 | 'INV.componentOf.Bi_PM_LC.PM_LC_Bi_Component'
 | 'INV.componentOf.Bidirectional_M-FEP.Sink_M-FEP_Bi_Component'
 | 'is_defined_by.Fowarding_Rule_Sk_SN.Forwarding_Function_CFTE_Sk'
 | 'set_egress.Fowarding_Rule_Sk_SN.Egress_SN_Sk'
 | 'componentOf.Bidirectional_SN-FEP.Sink_SN-FEP_Bi_Component'
 | 'binds_So_L-FP.LPF_Output_-_So_L-FP_Bound.A_So_Input_-_So_L-FP_Bound'
 | 'componentOf.Bi_Intermediate_MC.Intermediate_MC_Bi_Component'
 | 'is_configured_by.So_MC_Forwarding.Forwarding_Function_So_M_Connected'
 | 'componentOf.Bidirectional_AP.Sink_AP_Bi_Component'
 | 'set_egress.Forwarding_Rule_MC_So.Egress_MC_So'
 | 'set_egress.Forwarding_Rule_MC_Sk-So.Egress_MC_Sk-So'
 | 'INV.componentOf.Multiple_Equipment_Composed_Site.Equipment_Site_Component'
 | 'componentOf.Adaptation_Source.Adaptation_Source_Output'
 | 'INV.componentOf.Layer_Processor_Function_Sink.Layer_Processor_Process'
 | 'is_defined_by.Forwarding_Rule_So_SN.Forwarding_Function_CFTE_So'
 | 'INV.set_egress.Forwarding_Rule_So-Sk.Egress_SN_Sk-So'
 | 'INV.supports.Supporting_MC.NC_Supported_by_MC'
 | 'INV.set_ingress.Forwarding_Rule_MC_Sk.Ingress_MC_Sk'
 | 'INV.componentOf.Layer_Processor_Function_Source.Layer_Processor_Source_Input'
 | 'componentOf.Unidirectional_Matrix.Matrix_Input'
 | 'componentOf.Bi_Path_CFTE.Sink_CFTE_Bi_Component'
 | 'INV.componentOf.Bidirectional_AP.Source_AP_Bi_Component'
 | 'INV.componentOf.Bidirectional_LPF-FEP.Source_LPF-FEP_Bi_Component'
 | 'INV.set_egress.Forwarding_Rule_MC_So.Egress_MC_So'
 | 'INV.componentOf.Termination_Source.Termination_Source_Process'
 | 'supports.Supporting_LC.NC_Supported_by_LC'
 | 'componentOf.Path_Bidirectional_Matrix.So_Matrix_Bi_Component'
 | 'INV.componentOf.Adaptation_Sink.Adaptation_Sink_Input'
 | 'INV.is_defined_by.Forwarding_Rule_So_SN.Forwarding_Function_CFTE_So'
 | 'componentOf.Bidirectional_PM-FEP.Sink_PM-FEP_Bi_Component'
 | 'componentOf.Path_Bidirectional_Matrix.Sk_Matrix_Bi_Component'
 | 'INV.is_defined_by.Forwarding_Rule_So-Sk.Forwarding_Function_CFTE_So-Sk'
 | 'INV.supports.Supporting_Access_Transport_Entity.Path_LC'
 | 'INV.is_configured_by.So_MC_Forwarding.Forwarding_Function_So_M_Connected'
 | 'INV.componentOf.Physical_Media_Layer_Network.Physical_Media_Layer_Termination'
 | 'INV.componentOf.Bi_Path_LC.Path_LC_Bi_Component'
 | 'is_defined_by.Int_MC_Forwarding.Forwarding_Rule_MC_Sk-So'
 | 'INV.componentOf.Section_Layer_Network.Section_Layer_Termination'
 | 'INV.componentOf.Path_Layer_Network.Path_Layer_Termination'
 | 'componentOf.Topological_Layer.Access_Group'
 | 'componentOf.Layer_Processor_Function_Source.Layer_Processor_Source_Process'
 | 'componentOf.LC_Composed_Layer_Network.Link_Connection'
 | 'INV.set_ingress.Fowarding_Rule_Sk_SN.Ingress_SN_Sk'
 | 'INV.represents.Single_Equipment_Site.Single_Equipment_Site_Component'
 | 'INV.is_defined_by.Fowarding_Rule_Sk_SN.Forwarding_Function_CFTE_Sk'
 | 'componentOf.Termination_Source.Termination_Source_Input'
 | 'componentOf.Matrix_Composed_Path_Layer.Component_Matrix'
 | 'represents.Topological_M_Representation.Matrix'
 | 'INV.componentOf.Bidirectional_SN-FEP.Sink_SN-FEP_Bi_Component'
 | 'INV.is_configured_by.Path_LC_Forwarding.Forwarding_Function_LC_Connected'
 | 'INV.is_defined_by.Forwarding_Rule_MC_So.Forwarding_Function_So_M_Connected'
 | 'INV.componentOf.Layer_Processor_Function_Source.Layer_Processor_Source_Process'
 | 'componentOf.Bidirectional_SN-FP.Source_SN-FP_Bi_Component'
 | 'is_configured_by.Sk_CFTE_Forwarding.Forwarding_Function_CFTE_Sk'
 | 'INV.componentOf.Bidirectional_LP-FP.Source_LP-FP_Bi_Component'
 | 'componentOf.Layer_Processor_Function_Sink.Layer_Processor_Process'
 | 'componentOf.Equipment.Input_Interface'
 | 'INV.componentOf.Bi_Path_CFTE.Source_CFTE_Bi_Component'
 | 'INV.componentOf.Termination_Sink.Termination_Sink_Output'
 | 'componentOf.Bidirectional_PM_NC.Unidirectional_PM_NC_Bidirectional_Component'
 | 'represents.Topological_SN_Representation.Subnetwork'
 | 'componentOf.Equipment.Transport_Funtion_Equipment_Component'
 | 'INV.componentOf.Composed_Topological_Layer.Connected_Relatable_TC'
 | 'is_defined_by.Forwarding_Rule_Sk-So.Forwarding_Function_CFTE_Sk-So'
 | 'componentOf.Layer_Processor_Function_Sink.Layer_Processor_Sink_Output'
 | 'is_configured_by.Path_LC_Forwarding.Forwarding_Function_LC_Connected'
 | 'INV.componentOf.Bi_Intermediate_MC.Intermediate_MC_Bi_Component'
 | 'is_defined_by.Forwarding_Rule_MC_Sk.Sk_MC_Forwarding'
 | 'componentOf.Termination_Sink.Termination_Sink_Input'
 | 'is_configured_by.So_CFTE_Forwarding.Forwarding_Function_CFTE_So'
 | 'INV.componentOf.Layer_Processor_Function_Sink.Layer_Processor_Sink_Input'
 | 'INV.componentOf.Bidirectional_LP-FP.Sink_LP-FP_Bi_Component'
 | 'INV.componentOf.Adaptation_Source.Adaptation_Source_Input'
 | 'componentOf.Termination_Source.Termination_Source_Output'
 | 'componentOf.Unidirectional_Matrix.Matrix_Output'
 | 'componentOf.Bi_PM_LC.PM_LC_Bi_Component'
 | 'componentOf.Bidirectional_M-FP.Source_M-FP_Bi_Component'
 | 'INV.componentOf.Termination_Sink.Termination_Sink_Input'
 | 'componentOf.Section_Layer_Network.Section_Layer_Termination'
 | 'componentOf.Path_Layer_Network.Component_LPF'
 | 'set_ingress.Forwarding_Rule_So-Sk.Ingress_SN_So-Sk'
 | 'componentOf.Bidirectional_A-FP.Uni_A-FP_Bi_Component'
 | 'INV.componentOf.Bidirectional_Sink-Source_Matrix.Uni_Sk-So_Matrix_Bi_Component'
 | 'INV.componentOf.Bidirectional_SN-FP.Sink_SN-FP_Bi_Component'
 | 'componentOf.Bidirectional_PM-FEP.Source_PM-FEP_Bi_Component'
 | 'INV.componentOf.Unidirectional_Matrix.Matrix_Input'
 | 'componentOf.Equipment.Output_Interface'
 | 'is_configured_by.End_Forwarding.Forwarding_Function_CFTE_So-Sk'
 | 'INV.componentOf.Bidirectional_PM_NC.Unidirectional_PM_NC_Bidirectional_Component'
 | 'INV.componentOf.Adaptation_Sink.Adaptation_Sink_Output'
 | 'componentOf.Layer_Processor_Function_Sink.Layer_Processor_Sink_Input'
 | 'INV.componentOf.Adaptation_Source.Adaptation_Source_Process'
 | 'set_egress.Forwarding_Rule_LC.Egress_LC'
 | 'INV.set_ingress.Forwarding_Rule_So_SN.Ingress_SN_So'
 | 'INV.componentOf.Bidirectional_Termination.Termination_Sk_Bidirectional_Component'
 | 'set_ingress.Forwarding_Rule_MC_Sk.Ingress_MC_Sk'
 | 'INV.componentOf.Subnetwork_Composed_Path_Layer.Component_Subnetwork'
 | 'componentOf.Bidirectional_Adaptation.Adaptation_So_Bidirectional_Component'
 | 'INV.componentOf.Bidirectional_Layer_Processor_Function.LPF_Sk_Bidirectional_Component'
 | 'INV.componentOf.Termination_Sink.Termination_Sink_Process'
 | 'componentOf.Bidirectional_Termination.Termination_So_Bidirectional_Component'
 | 'supports.Supporting_MC.NC_Supported_by_MC'
 | 'INV.componentOf.Single_Physical_Media.Physical_Media_Input'
 | 'represents.Composed_AG.Co-located_Termination'
 | 'INV.set_ingress.Forwarding_Rule_LC.Ingress_LC'
 | 'componentOf.Bidirectional_A-FEP.Sink_A-FEP_Bi_Component'
 | 'INV.componentOf.Equipment.Transport_Funtion_Equipment_Component'
 | 'INV.componentOf.Bi_Path_MC.Sink_MC_Bi_Component'
 | 'componentOf.Bi_Path_CFTE.Source_CFTE_Bi_Component'
 | 'INV.componentOf.Layer_Processor_Function_Source.Layer_Processor_Source_Output'
 | 'componentOf.Bidirectional_Sink-Source_Matrix.Uni_Sk-So_Matrix_Bi_Component'
 | 'componentOf.Bi_Path_MC.Source_MC_Bi_Component'
 | 'INV.set_egress.Forwarding_Rule_So_SN.Egress_SN_So'
 | 'INV.set_egress.Forwarding_Rule_LC.Egress_LC'
 | 'INV.componentOf.Unidirectional_Matrix.Matrix_Output'
 | 'componentOf.Bidirectional_Termination.Termination_Sk_Bidirectional_Component'
 | 'INV.set_ingress.Forwarding_Rule_So-Sk.Ingress_SN_So-Sk'
 | 'INV.represents.Topological_Layer.Layer_Network'
 | 'componentOf.Bidirectional_M-FP.Sink_M-FP_Bi_Component'
 | 'INV.is_configured_by.Sk_CFTE_Forwarding.Forwarding_Function_CFTE_Sk'
 | 'componentOf.Path_Layer_Network.Path_Layer_Termination'
 | 'INV.binds_So_A-FEP'
 | 'INV.has_equipment'
 | 'INV.is_represented_by_So_SN-FP'
 | 'INV.is_represented_by_Sk_M-FEP'
 | 'Forwarding_End_CFTE'
 | 'INV.T-PM_Source_Connection'
 | 'Forwarding_Bidirectional_End_CFTE'
 | 'INV.binds_So_A-FEP_to'
 | 'binds_So_LPF-FEP'
 | 'is_represented_by_A-FP'
 | 'Forwarding_from_Source_CFTE'
 | 'Forwarding_from_Sink_MC'
 | 'INV.Forwarding_from_Uni_Access_Transport_Entity'
 | 'INV.binds_Sk_A-FEP_from'
 | 'T-PM_Sink_Connection'
 | 'INV.path'
 | 'INV.Forwarding_to_Intermediate_CFTE'
 | 'Forwarding_from_Sink_CFTE'
 | 'binds_Sk_M-FEP_to'
 | 'INV.te_connected'
 | 'INV.Forwarding_from_PM_LC'
 | 'INV.is_connecting'
 | 'Forwarding_to_PM_LC'
 | 'Defined_Geographical_Element.longitude.minute'
 | 'INV.binds_So_LPF-FP_to'
 | 'binds_Sk_SN-FP_from'
 | 'binds_A-FP_to'
 | 'INV.binds_So_AP'
 | 'INV.Forwarding_from_Intermediate_CFTE'
 | 'Forwarding_from_Intermediate_CFTE'
 | 'Defined_Geographical_Element.latitude.minute'
 | 'A-A_Bidirectional_Connection'
 | 'is_represented_by_Intermediate_MC'
 | 'binds_So_PM-FEP_to'
 | 'INV.L-A_Sink_Connection'
 | 'T-M_Source_Connection'
 | 'Forwarding_PM_LC'
 | 'binds_Sk_M-FEP'
 | 'INV.Forwarding_Bidirectional_Path_MC_FP'
 | 'is_represented_by_Sk_SN-FEP'
 | 'is_represented_by_Sk_M-FEP'
 | 'INV.is_represented_by_Source_MC'
 | 'isDefinedBy'
 | 'INV.binding_is_represented_by'
 | 'Forwarding_Bidirectional_Int_CFTE'
 | 'has_forwarding'
 | 'binds_Sk_LPF-FEP_to'
 | 'INV.Forwarding_to_PM_LC'
 | 'binds_Sk_LPF-FP_from'
 | 'is_represented_by_So_A-FEP'
 | 'INV.Forwarding_from_Intermediate_MC'
 | 'INV.LA_-_Bidirectional_Connection'
 | 'is_represented_by_Sk_AP'
 | 'binds_So_LPF-FP_from'
 | 'INV.binds_So_SN-FEP'
 | 'INV.A-T_Sink_Connection'
 | 'is_represented_by_Source_CFTE'
 | 'is_represented_by_So_PM-FEP'
 | 'INV.binds_Sk_AP_from'
 | 'T-L_Source_Connection'
 | 'Forwarding_to_Uni_Access_Transport_Entity'
 | 'INV.T-A_Sink_Connection'
 | 'INV.Forwarding_from_Sink_CFTE'
 | 'L-A_Sink_Connection'
 | 'Forwarding_from_End_CFTE'
 | 'is_represented_by_Uni_PM_NC'
 | 'INV.Sn-A_Source_Connection'
 | 'INV.T-PM_Bidirectional_Connection'
 | 'interface_binds'
 | 'INV.has_forwarding'
 | 'INV.Sn-A_Sink_Connection'
 | 'INV.binds_So_L-FP_to'
 | 'INV.binds'
 | 'INV.Forwarding_Source_MC'
 | 'binds_Sk_M-FP'
 | 'INV.binds_Sk_L-FP_from'
 | 'INV.binds_Sk_LPF-FEP_to'
 | 'binds_So_PM-FEP_from'
 | 'INV.M-A_Source_Connection'
 | 'T-M_Sink_Connection'
 | 'is_represented_by_So_M-FP'
 | 'INV.binds_Sk_SN-FEP_from'
 | 'INV.T-SN_Bidirectional_Connection'
 | 'te_connected'
 | 'INV.T-PM_Sink_Connection'
 | 'INV.binds_PM_out_interface'
 | 'Forwarding_Source_MC'
 | 'is_represented_by_End_CFTE'
 | 'binds_So_M-FP_from'
 | 'is_represented_by_So_AP'
 | 'Section-PM_client-server_layer_relationship'
 | 'INV.Forwarding_Bidirectional_PM_FEP'
 | 'INV.binds_Sk_M-FEP_to'
 | 'INV.binds_Sk_M-FP_from'
 | 'is_represented_by_Uni_Access_Transport_Entity'
 | 'binds_So_LPF-FP_to'
 | 'Forwarding_to_End_CFTE'
 | 'INV.maps_input'
 | 'binds_So_LPF-FEP_to'
 | 'INV.is_represented_by_Path_LC'
 | 'INV.binds_Sk_LPF-FEP_from'
 | 'INV.Forwarding_Bidirectional_PM_NC'
 | 'INV.Forwarding_to_Sink_CFTE'
 | 'Forwarding_to_Uni_Path_NC'
 | 'binds_Sk_AP_to'
 | 'INV.interface_connects'
 | 'is_represented_by_Sk_A-FEP'
 | 'INV.is_represented_by_Sk_AP'
 | 'Path-Path_client-server_layer_relationship'
 | 'INV.interface_binds'
 | 'INV.binds_So_PM-FEP'
 | 'INV.Forwarding_Bidirectional_Int_CFTE'
 | 'A-T_Sink_Connection'
 | 'maps_input'
 | 'INV.Forwarding_to_Uni_Access_Transport_Entity'
 | 'binds_Sk_SN-FP_to'
 | 'INV.binds_Sk_LPF-FP'
 | 'INV.is_represented_by_Sink_MC'
 | 'T-M_Bidirectional_Connection'
 | 'INV.M-A_Bidirectional_Connection'
 | 'is_represented_by_So_SN-FEP'
 | 'M-A_Source_Connection'
 | 'INV.is_represented_by_So_SN-FEP'
 | 'INV.A-T_Bidirectional_Connection'
 | 'Sn-A_Source_Connection'
 | 'INV.is_represented_by_So_M-FEP'
 | 'INV.binds_So_SN-FEP_from'
 | 'is_represented_by_So_LP-FP'
 | 'INV.T-A_Source_Connection'
 | 'is_represented_by_Sk_LP-FP'
 | 'INV.binds_Sk_PM-FEP_from'
 | 'INV.Forwarding_Bidirectional_End_CFTE'
 | 'Defined_Geographical_Element.longitude.degree'
 | 'INV.binds_So_A-FEP_from'
 | 'INV.binds_So_PM-FEP_to'
 | 'INV.M-A_Sink_Connection'
 | 'INV.Forwarding_Path_LC'
 | 'INV.binds_Sk_SN-FEP_to'
 | 'INV.Forwarding_End_CFTE'
 | 'INV.Forwarding_from_End_CFTE'
 | 'A-A_Connection'
 | 'INV.binds_PM_in_interface'
 | 'binds_PM_out_interface'
 | 'binds_So_SN-FP_to'
 | 'INV.binds_So_PM-FEP_from'
 | 'INV.Forwarding_to_Sink_MC'
 | 'Forwarding_Source_CFTE'
 | 'INV.binds_A-FP'
 | 'INV.is_represented_by_Source_CFTE'
 | 'Forwarding_to_Intermediate_CFTE'
 | 'binds_So_A-FEP_from'
 | 'Forwarding_Int_CFTE'
 | 'INV.binds_Sk_A-FEP_to'
 | 'is_represented_by_So_LPF-FEP'
 | 'Geographical_Element_With_Alias.location'
 | 'INV.is_represented_by_Uni_Path_NC'
 | 'Defined_Geographical_Element.longitude.second'
 | 'INV.binds_Sk_M-FEP_from'
 | 'binds_So_M-FEP'
 | 'INV.binds_Sk_AP'
 | 'INV.binds_So_LPF-FEP_to'
 | 'INV.T-M_Bidirectional_Connection'
 | 'binds_So_SN-FEP_from'
 | 'binds_Sk_PM-FEP_to'
 | 'INV.maps_output'
 | 'binds_Sk_A-FEP_to'
 | 'INV.T-L_Bidirectional_Connection'
 | 'Forwarding_Bidirectional_Path_MC_FEP'
 | 'INV.binds_So_LPF-FP_from'
 | 'INV.is_represented_by_So_LPF-FEP'
 | 'INV.binds_Sk_LPF-FP_to'
 | 'binds_Sk_LPF-FEP'
 | 'INV.site_connects'
 | 'INV.binds_So_L-FP_from'
 | 'maps_output'
 | 'Forwarding_Sink_CFTE'
 | 'INV.is_binding'
 | 'INV.binds_So_SN-FP_from'
 | 'INV.binds_Sk_AP_to'
 | 'INV.binds_Sk_SN-FEP'
 | 'INV.is_represented_by_Sk_LP-FP'
 | 'binds_Sk_SN-FEP'
 | 'is_represented_by_Sk_M-FP'
 | 'binds_Sk_L-FP_from'
 | 'Forwarding_Bidirectional_PM_NC'
 | 'INV.binds_Sk_SN-FP'
 | 'binds_Sk_M-FP_from'
 | 'binds_Sk_AP_from'
 | 'INV.binds_Sk_M-FEP'
 | 'INV.Forwarding_Bidirectional_Int_MC'
 | 'INV.Forwarding_Int_CFTE'
 | 'INV.tf_connection'
 | 'INV.Forwarding_from_Source_CFTE'
 | 'binds_So_A-FEP_to'
 | 'INV.is_represented_by_End_CFTE'
 | 'T-SN_Bidirectional_Connection'
 | 'Forwarding_to_Sink_MC'
 | 'binds_Sk_A-FEP_from'
 | 'binds_So_A-FEP'
 | 'INV.Forwarding_Bidirectional_Path_CFTE_FP'
 | 'T-A_Bidirectional_Connection'
 | 'Forwarding_to_Path_LC'
 | 'INV.is_represented_by_So_M-FP'
 | 'INV.is_represented_by_Sink_CFTE'
 | 'binds_Sk_M-FEP_from'
 | 'binds_So_M-FEP_to'
 | 'INV.Forwarding_to_Path_LC'
 | 'T-PM_Bidirectional_Connection'
 | 'Defined_Geographical_Element.latitude.degree'
 | 'binds_Sk_LPF-FP'
 | 'INV.T-L_Source_Connection'
 | 'INV.binds_Sk_LPF-FP_from'
 | 'INV.A-A_Connection'
 | 'binds_So_LPF-FEP_from'
 | 'INV.isDefinedBy'
 | 'binds_Sk_SN-FEP_from'
 | 'Forwarding_to_Source_MC'
 | 'is_represented_by_So_L-FP'
 | 'binds_Sk_L-FP_to'
 | 'is_represented_by_Path_LC'
 | 'INV.Forwarding_from_Path_LC'
 | 'INV.binds_So_LPF-FEP_from'
 | 'INV.binds_So_SN-FP_to'
 | 'INV.connects'
 | 'binds_So_AP_to'
 | 'INV.Forwarding_from_Uni_Path_NC'
 | 'INV.is_represented_by_Sk_M-FP'
 | 'M-A_Sink_Connection'
 | 'Defined_Geographical_Element.latitude.second'
 | 'INV.binds_So_SN-FEP_to'
 | 'client-server_layer_relationship'
 | 'INV.Forwarding_Bidirectional_Path_CFTE_FEP'
 | 'INV.is_represented_by_Sk_PM-FEP'
 | 'INV.is_represented_by_Sk_SN-FP'
 | 'is_connecting'
 | 'INV.T-M_Source_Connection'
 | 'Forwarding_Intermediate_MC'
 | 'Forwarding_Bidirectional_Int_MC'
 | 'Sn-A_Sink_Connection'
 | 'INV.Forwarding_Source_CFTE'
 | 'SN-A_Bidirectional_Connection'
 | 'binds_Sk_SN-FP'
 | 'Forwarding_Path_LC'
 | 'is_represented_by_Sink_CFTE'
 | 'Forwarding_to_Intermediate_MC'
 | 'binds_So_SN-FP_from'
 | 'is_represented_by_PM_LC'
 | 'Forwarding_from_Uni_PM_NC'
 | 'binds_A-FP_from'
 | 'INV.binds_So_M-FEP_from'
 | 'Forwarding_from_PM_LC'
 | 'is_binding'
 | 'is_represented_by_So_SN-FP'
 | 'binds_Sk_PM-FEP_from'
 | '/L-A_Source_Connection'
 | 'INV.Forwarding_to_Intermediate_MC'
 | 'INV.Forwarding_Bidirectional_Access_Transport_Entity'
 | 'binds_So_L-FP_from'
 | 'Forwarding_Bidirectional_Path_NC'
 | 'INV.Path-Section_client-server_layer_relationship'
 | 'INV.A-A_Bidirectional_Connection'
 | 'INV.is_represented_by_So_L-FP'
 | 'INV.is_represented_by_Sk_A-FEP'
 | 'site_connects'
 | 'is_represented_by_So_M-FEP'
 | 'binds_So_M-FEP_from'
 | 'IT_is_represented_by'
 | 'INV.Forwarding_to_Source_MC'
 | 'path'
 | 'binds_Sk_LPF-FP_to'
 | 'binds_Sk_PM-FEP'
 | 'binds_So_L-FP_to'
 | 'INV.T-L_Sink_Connection'
 | 'INV.binds_So_M-FP_from'
 | 'INV.binds_Sk_PM-FEP_to'
 | 'INV.Forwarding_Path_NC'
 | 'INV.SN-A_Bidirectional_Connection'
 | 'is_represented_by_Sink_MC'
 | 'INV.is_represented_by_So_AP'
 | 'INV.is_represented_by_Sk_L-FP'
 | 'INV.Forwarding_from_Uni_PM_NC'
 | 'INV.is_represented_by_So_PM-FEP'
 | 'Forwarding_Bidirectional_Path_MC_FP'
 | 'INV./L-A_Source_Connection'
 | 'INV.binds_A-FP_to'
 | 'Forwarding_Bidirectional_Path_LC'
 | 'is_represented_by_Sk_SN-FP'
 | 'INV.binds_So_AP_to'
 | 'INV.Path-Path_client-server_layer_relationship'
 | 'Forwarding_Path_NC'
 | 'Forwarding_to_Source_CFTE'
 | 'INV.binds_So_LPF-FP'
 | 'INV.Forwarding_to_Source_CFTE'
 | 'Forwarding_Bidirectional_Access_Transport_Entity'
 | 'INV.T-SN_Source_Connection'
 | 'binding_is_represented_by'
 | 'binds_Sk_M-FP_to'
 | 'Forwarding_Bidirectional_Path_CFTE_FP'
 | 'binds_PM_in_interface'
 | 'INV.T-A_Bidirectional_Connection'
 | 'INV.Forwarding_to_End_CFTE'
 | 'INV.Forwarding_PM_NC'
 | 'INV.binds_So_M-FP'
 | 'LA_-_Bidirectional_Connection'
 | 'A-T_Bidirectional_Connection'
 | 'A-T_Source_Connection'
 | 'binds_Sk_LPF-FEP_from'
 | 'is_represented_by_Uni_Path_NC'
 | 'binds_So_SN-FP'
 | 'Forwarding_Bidirectional_PM_FEP'
 | 'Forwarding_PM_NC'
 | 'is_represented_by_Source_MC'
 | 'T-L_Sink_Connection'
 | 'INV.binds_Sk_SN-FP_to'
 | 'INV.binds_So_AP_from'
 | 'Path-Section_client-server_layer_relationship'
 | 'Forwarding_to_Sink_CFTE'
 | 'M-A_Bidirectional_Connection'
 | 'INV.Forwarding_Intermediate_MC'
 | 'binds_So_AP_from'
 | 'T-SN_Source_Connection'
 | 'INV.binds_So_M-FEP_to'
 | 'binds_So_LPF-FP'
 | 'T-A_Sink_Connection'
 | 'INV.binds_Sk_A-FEP'
 | 'INV.Forwarding_Bidirectional_Path_MC_FEP'
 | 'INV.Forwarding_Sink_MC'
 | 'INV.Forwarding_PM_LC'
 | 'is_represented_by_Sk_LPF-FEP'
 | 'Forwarding_from_Uni_Access_Transport_Entity'
 | 'Forwarding_from_Path_LC'
 | 'INV.binds_So_M-FEP'
 | 'T-A_Source_Connection'
 | 'T-L_Bidirectional_Connection'
 | 'binds_Sk_A-FEP'
 | 'is_represented_by_Intermediate_CFTE'
 | 'INV.is_represented_by_Uni_PM_NC'
 | 'binds_Sk_AP'
 | 'connects'
 | 'INV.is_represented_by_Intermediate_MC'
 | 'INV.binds_Sk_SN-FP_from'
 | 'INV.T-SN_Sink_Connection'
 | 'INV.Section-PM_client-server_layer_relationship'
 | 'INV.Forwarding_Sink_CFTE'
 | 'is_represented_by_Sk_L-FP'
 | 'binds_Sk_SN-FEP_to'
 | 'Forwarding_Unidirectional_Access_Transport_Entity'
 | 'binds_A-FP'
 | 'Forwarding_to_Uni_PM_NC'
 | 'interface_connects'
 | 'INV.binds_Sk_M-FP_to'
 | 'Forwarding_from_Uni_Path_NC'
 | 'INV.binds_So_SN-FP'
 | 'INV.binds_So_LPF-FEP'
 | 'INV.is_represented_by_Intermediate_CFTE'
 | 'INV.Forwarding_from_Sink_MC'
 | 'INV.binds_Sk_L-FP_to'
 | 'INV.binds_Sk_LPF-FEP'
 | 'INV.T-M_Sink_Connection'
 | 'binds_So_SN-FEP'
 | 'INV.binds_Sk_PM-FEP'
 | 'INV.binds_Sk_M-FP'
 | 'INV.is_represented_by_A-FP'
 | 'INV.binds_So_M-FP_to'
 | 'INV.is_represented_by_So_LP-FP'
 | 'INV.binds_A-FP_from'
 | 'INV.A-T_Source_Connection'
 | 'INV.is_represented_by_PM_LC'
 | 'INV.client-server_layer_relationship'
 | 'Termination_Function.type'
 | 'has_equipment'
 | 'Forwarding_Bidirectional_Path_CFTE_FEP'
 | 'INV.Forwarding_Bidirectional_Path_NC'
 | 'INV.Forwarding_to_Uni_PM_NC'
 | 'INV.is_represented_by_Sk_SN-FEP'
 | 'T-SN_Sink_Connection'
 | 'binds_So_AP'
 | 'INV.Forwarding_Bidirectional_Path_LC'
 | 'INV.Forwarding_from_Source_MC'
 | 'INV.is_represented_by_So_A-FEP'
 | 'INV.Forwarding_to_Uni_Path_NC'
 | 'Forwarding_from_Source_MC'
 | 'INV.IT_is_represented_by'
 | 'INV.is_represented_by_Uni_Access_Transport_Entity'
 | 'Forwarding_Sink_MC'
 | 'binds_So_SN-FEP_to'
 | 'binds_So_PM-FEP'
 | 'binds'
 | 'binds_So_M-FP'
 | 'tf_connection'
 | 'T-PM_Source_Connection'
 | 'Forwarding_from_Intermediate_MC'
 | 'INV.Forwarding_Unidirectional_Access_Transport_Entity'
 | 'INV.is_represented_by_Sk_LPF-FEP'
 | 'is_represented_by_Sk_PM-FEP'
 | 'binds_So_M-FP_to'
;
%%